name	taxonomy_id	taxonomy_lvl	kraken_assigned_reads	added_reads	new_est_reads	fraction_total_reads
Mycobacterium dioxanotrophicus	482462	S	453728	57405	511133	0.04955
Mycobacterium sp. TY59	2775496	S	5584	899	6483	0.00063
Mycobacterium sp. DL440	2675523	S	5035	581	5616	0.00054
Mycobacterium sp. JS623	212767	S	3531	199	3730	0.00036
Mycobacterium sp. EPa45	1545728	S	2920	345	3265	0.00032
Mycobacterium sp. YC-RL4	1682113	S	2283	472	2755	0.00027
Mycobacterium sp. MS1601	1936029	S	2183	187	2370	0.00023
Mycobacterium sp. DL592	2675524	S	2139	233	2372	0.00023
Mycobacterium sp. IDR2000157661	2867005	S	2080	241	2321	0.00023
Mycobacterium sp. WY10	1920667	S	1006	4749	5755	0.00056
Mycobacterium mantenii	560555	S	6212	573	6785	0.00066
Mycobacterium colombiense	339268	S	5573	719	6292	0.00061
Mycobacterium avium	1764	S	4949	2536	7485	0.00073
Mycobacterium marseillense	701042	S	3622	625	4247	0.00041
Mycobacterium intracellulare	1767	S	2302	21252	23554	0.00228
Mycobacterium saskatchewanense	220927	S	2673	431	3104	0.00030
Mycobacterium heidelbergense	53376	S	2541	490	3031	0.00029
Mycobacterium parmense	185642	S	2541	392	2933	0.00028
Mycobacterium kubicae	120959	S	2153	285	2438	0.00024
Mycobacterium shigaense	722731	S	2118	233	2351	0.00023
Mycobacterium lentiflavum	141349	S	1945	385	2330	0.00023
Mycobacterium florentinum	292462	S	1925	368	2293	0.00022
Mycobacterium simiae	1784	S	1903	122	2025	0.00020
Mycobacterium stomatepiae	470076	S	1793	310	2103	0.00020
Mycobacterium rufum	318424	S	9810	1610	11420	0.00111
Mycobacterium virginiense	1795032	S	8762	1204	9966	0.00097
Mycobacterium goodii	134601	S	3771	656	4427	0.00043
Mycobacterium crocinum	388459	S	3669	1791	5460	0.00053
Mycobacterium conspicuum	44010	S	3662	330	3992	0.00039
Mycobacterium grossiae	1552759	S	2937	511	3448	0.00033
Mycobacterium frederiksbergense	117567	S	2920	476	3396	0.00033
Mycobacterium paraterrae	577492	S	2804	192	2996	0.00029
Mycobacterium diernhoferi	1801	S	2785	330	3115	0.00030
Mycobacterium cookii	1775	S	2364	155	2519	0.00024
Mycobacterium branderi	43348	S	2317	179	2496	0.00024
Mycobacterium holsaticum	152142	S	2230	209	2439	0.00024
Mycobacterium paragordonae	1389713	S	2013	168	2181	0.00021
Mycobacterium malmoense	1780	S	1983	244	2227	0.00022
Mycobacterium gordonae	1778	S	1770	91	1861	0.00018
Mycobacterium paraseoulense	590652	S	1635	287	1922	0.00019
Mycobacterium riyadhense	486698	S	1599	47	1646	0.00016
Mycobacterium seoulense	386911	S	1562	317	1879	0.00018
Mycobacterium vicinigordonae	1719132	S	1472	54	1526	0.00015
Mycobacterium kansasii	1768	S	1457	113	1570	0.00015
Mycobacterium noviomagense	459858	S	1453	78	1531	0.00015
Mycobacterium lacus	169765	S	1431	74	1505	0.00015
Mycobacterium ostraviense	2738409	S	1344	120	1464	0.00014
Mycobacterium koreense	1069220	S	1334	205	1539	0.00015
Mycobacterium heckeshornense	110505	S	1329	81	1410	0.00014
Mycobacterium shinjukuense	398694	S	1177	85	1262	0.00012
Mycobacterium basiliense	2094119	S	1093	27	1120	0.00011
Mycobacterium xenopi	1789	S	1085	91	1176	0.00011
Mycolicibacterium mageritense	53462	S	20963	2121	23084	0.00224
Mycolicibacterium fortuitum	1766	S	12623	2522	15145	0.00147
Mycolicibacterium neoaurum	1795	S	10132	2027	12159	0.00118
Mycolicibacterium boenickei	146017	S	8099	8780	16879	0.00164
Mycolicibacterium septicum	98668	S	7168	3712	10880	0.00105
Mycolicibacterium smegmatis	1772	S	6858	1516	8374	0.00081
Mycolicibacterium sp. YH-1	2908837	S	3864	2314	6178	0.00060
Mycolicibacterium litorale	758802	S	5511	956	6467	0.00063
Mycolicibacterium fluoranthenivorans	258505	S	4573	376	4949	0.00048
Mycolicibacterium alvei	67081	S	4532	726	5258	0.00051
Mycolicibacterium phocaicum	319706	S	4059	1552	5611	0.00054
Mycolicibacterium arabiense	1286181	S	3754	379	4133	0.00040
Mycolicibacterium madagascariense	212765	S	3360	332	3692	0.00036
Mycolicibacterium sediminis	1286180	S	3268	386	3654	0.00035
Mycolicibacterium parafortuitum	39692	S	3063	401	3464	0.00034
Mycolicibacterium vaccae	1810	S	3025	387	3412	0.00033
Mycolicibacterium rutilum	370526	S	2987	543	3530	0.00034
Mycolicibacterium tokaiense	39695	S	2912	282	3194	0.00031
Mycolicibacterium chubuense	1800	S	2840	379	3219	0.00031
Mycolicibacterium rhodesiae	36814	S	2789	284	3073	0.00030
Mycolicibacterium monacense	85693	S	2789	567	3356	0.00033
Mycolicibacterium phlei	1771	S	2781	610	3391	0.00033
Mycolicibacterium confluentis	28047	S	2759	270	3029	0.00029
Mycolicibacterium mucogenicum	56689	S	2738	842	3580	0.00035
Mycolicibacterium psychrotolerans	216929	S	2716	377	3093	0.00030
Mycolicibacterium helvum	1534349	S	2686	208	2894	0.00028
Mycolicibacterium chitae	1792	S	2658	411	3069	0.00030
Mycolicibacterium aichiense	1799	S	2558	263	2821	0.00027
Mycolicibacterium mengxianglii	2736649	S	2544	176	2720	0.00026
Mycolicibacterium aurum	1791	S	2514	215	2729	0.00026
Mycolicibacterium hassiacum	46351	S	2482	456	2938	0.00028
Mycolicibacterium poriferae	39694	S	2471	328	2799	0.00027
Mycolicibacterium baixiangningiae	2761578	S	2461	268	2729	0.00026
Mycolicibacterium moriokaense	39691	S	2402	189	2591	0.00025
Mycolicibacterium duvalii	39688	S	2384	303	2687	0.00026
Mycolicibacterium gilvum	1804	S	2357	505	2862	0.00028
Mycolicibacterium anyangense	1431246	S	2349	237	2586	0.00025
Mycolicibacterium celeriflavum	1249101	S	2337	264	2601	0.00025
Mycolicibacterium thermoresistibile	1797	S	2317	333	2650	0.00026
Mycolicibacterium gadium	1794	S	2274	196	2470	0.00024
Mycolicibacterium pulveris	36813	S	2255	241	2496	0.00024
Mycolicibacterium fallax	1793	S	1896	453	2349	0.00023
Mycolicibacterium insubricum	444597	S	1875	309	2184	0.00021
Mycolicibacterium farcinogenes	1802	S	1813	2569	4382	0.00042
Mycolicibacterium austroafricanum	39687	S	1786	5926	7712	0.00075
Mycolicibacterium sarraceniae	1534348	S	1630	137	1767	0.00017
Mycolicibacterium nivoides	2487344	S	1518	6052	7570	0.00073
Mycobacterium doricum	126673	S	1190	187	1377	0.00013
Mycobacteroides chelonae	1774	S	4386	1818	6204	0.00060
Mycobacteroides abscessus	36809	S	3681	2381	6062	0.00059
Mycobacteroides saopaulense	1578165	S	1444	124	1568	0.00015
Mycobacteroides salmoniphilum	404941	S	1410	96	1506	0.00015
Mycobacteroides immunogenum	83262	S	1315	154	1469	0.00014
Mycolicibacter sp. MYC340	2855503	S	1982	1212	3194	0.00031
Mycolicibacter sp. MYC098	2872309	S	1639	1121	2760	0.00027
Mycolicibacter hiberniae	29314	S	2072	321	2393	0.00023
Mycolicibacter minnesotensis	1118379	S	1792	229	2021	0.00020
Mycolicibacter terrae	1788	S	1739	377	2116	0.00021
Mycolicibacillus parakoreensis	1069221	S	1309	206	1515	0.00015
Nocardia nova	37330	S	24210	2762	26972	0.00261
Nocardia asteroides	1824	S	12381	3835	16216	0.00157
Nocardia terpenica	455432	S	8055	1206	9261	0.00090
Nocardia brasiliensis	37326	S	7810	1923	9733	0.00094
Nocardia cyriacigeorgica	135487	S	6276	2516	8792	0.00085
Nocardia wallacei	480035	S	5848	1644	7492	0.00073
Nocardia farcinica	37329	S	4100	2169	6269	0.00061
Nocardia arthritidis	228602	S	3459	368	3827	0.00037
Nocardia yamanashiensis	209247	S	3233	588	3821	0.00037
Nocardia tengchongensis	2055889	S	3185	756	3941	0.00038
Nocardia otitidiscaviarum	1823	S	3063	520	3583	0.00035
Nocardia huaxiensis	2755382	S	3004	533	3537	0.00034
Nocardia yunnanensis	2382165	S	2988	729	3717	0.00036
Nocardia gipuzkoensis	2749991	S	2830	1105	3935	0.00038
Nocardia sp. CS682	1047172	S	2673	631	3304	0.00032
Nocardia seriolae	37332	S	2643	696	3339	0.00032
Nocardia mangyaensis	2213200	S	2403	588	2991	0.00029
Nocardia iowensis	204891	S	2289	489	2778	0.00027
Rhodococcus sp. X156	2499145	S	2066	543	2609	0.00025
Rhodococcus sp. MTM3W5.2	1805827	S	1975	368	2343	0.00023
Rhodococcus sp. SGAir0479	2567884	S	1735	425	2160	0.00021
Rhodococcus sp. W8901	2742603	S	1694	391	2085	0.00020
Rhodococcus sp. PBTS 1	1653478	S	1490	285	1775	0.00017
Rhodococcus sp. R79	2811421	S	1294	1988	3282	0.00032
Rhodococcus sp. USK10	2789739	S	1095	1744	2839	0.00028
Rhodococcus sp. ABRD24	2507582	S	1068	165	1233	0.00012
Rhodococcus opacus	37919	S	12658	14768	27426	0.00266
Rhodococcus equi	43767	S	2794	763	3557	0.00034
Rhodococcus fascians	1828	S	2340	383	2723	0.00026
Rhodococcus qingshengii	334542	S	1231	9506	10737	0.00104
Rhodococcus rhodochrous	1829	S	1585	929	2514	0.00024
Rhodococcus koreensis	99653	S	1535	503	2038	0.00020
Rhodococcus triatomae	300028	S	1417	333	1750	0.00017
Rhodococcus jostii	132919	S	1191	556	1747	0.00017
Rhodococcus coprophilus	38310	S	1121	145	1266	0.00012
Corynebacterium cyclohexanicum	322009	S	4248	1325	5573	0.00054
Corynebacterium frankenforstense	1230998	S	1046	992	2038	0.00020
Corynebacterium xerosis	1725	S	1023	2657	3680	0.00036
Gordonia sp. PP30	2935861	S	1367	329	1696	0.00016
Gordonia sp. YC-JH1	2059875	S	1047	499	1546	0.00015
Gordonia sp. KTR9	337191	S	1010	415	1425	0.00014
Gordonia polyisoprenivorans	84595	S	2638	565	3203	0.00031
Gordonia terrae	2055	S	1677	2625	4302	0.00042
Gordonia insulae	2420509	S	1595	304	1899	0.00018
Gordonia amarae	36821	S	1322	216	1538	0.00015
Gordonia phthalatica	1136941	S	1251	438	1689	0.00016
Gordonia jinghuaiqii	2758710	S	1208	229	1437	0.00014
Gordonia bronchialis	2054	S	1205	346	1551	0.00015
Gordonia iterans	1004901	S	1154	272	1426	0.00014
Gordonia rubripertincta	36822	S	1079	1337	2416	0.00023
Gordonia pseudoamarae	2831662	S	1078	193	1271	0.00012
Gordonia otitidis	249058	S	1046	208	1254	0.00012
Skermania piniformis	39122	S	1351	116	1467	0.00014
Tsukamurella paurometabola	2061	S	2453	960	3413	0.00033
Tsukamurella tyrosinosolvens	57704	S	2057	733	2790	0.00027
Tsukamurella pulmonis	47312	S	1445	391	1836	0.00018
Tsukamurella sp. PLM1	2929795	S	1406	352	1758	0.00017
Segniliparus rotundus	286802	S	3263	138	3401	0.00033
Tomitella gaofuii	2760083	S	1310	308	1618	0.00016
Tomitella fengzijianii	2597660	S	1242	316	1558	0.00015
Streptomyces sp. GQFP	2907545	S	39252	7472	46724	0.00453
Streptomyces sp. SN-593	659352	S	10479	2282	12761	0.00124
Streptomyces sp. CdTB01	1725411	S	9502	3016	12518	0.00121
Streptomyces sp. 3214.6	1882757	S	7277	2421	9698	0.00094
Streptomyces sp. ZYC-3	2797636	S	5969	1371	7340	0.00071
Streptomyces sp. BH-MK-02	2880933	S	5945	1313	7258	0.00070
Streptomyces sp. P3	2135430	S	5911	1694	7605	0.00074
Streptomyces sp. So13.3	2136173	S	5529	985	6514	0.00063
Streptomyces sp. CB01881	2078691	S	5280	994	6274	0.00061
Streptomyces sp. A2-16	2781734	S	5138	1818	6956	0.00067
Streptomyces sp. SAT1	1849967	S	5094	1995	7089	0.00069
Streptomyces sp. ST1015	1848900	S	4765	1055	5820	0.00056
Streptomyces sp. NEAU-sy36	2751189	S	4642	1935	6577	0.00064
Streptomyces sp. SCSIO 64649	2878388	S	4521	753	5274	0.00051
Streptomyces sp. Go 40/10	2825844	S	4319	2338	6657	0.00065
Streptomyces sp. LRE541	2931983	S	4235	1097	5332	0.00052
Streptomyces sp. Z423-1	2730915	S	4019	1306	5325	0.00052
Streptomyces sp. DSM 40868	2721173	S	4003	1671	5674	0.00055
Streptomyces sp. NA02950	2742137	S	3831	783	4614	0.00045
Streptomyces sp. NHF165	2175864	S	3703	621	4324	0.00042
Streptomyces sp. WAC 01438	2203204	S	3635	1338	4973	0.00048
Streptomyces sp. MA3_2.13	2867410	S	3486	418	3904	0.00038
Streptomyces sp. SCUT-3	2684469	S	3485	1258	4743	0.00046
Streptomyces sp. AMCC400023	2056258	S	3442	1879	5321	0.00052
Streptomyces sp. RPA4-2	2721244	S	3417	1152	4569	0.00044
Streptomyces sp. JB150	2714844	S	3416	1328	4744	0.00046
Streptomyces sp. AgN23	1188315	S	3389	3533	6922	0.00067
Streptomyces sp. MG62	2838015	S	3349	1453	4802	0.00047
Streptomyces sp. HM190	2695266	S	3220	1122	4342	0.00042
Streptomyces sp. GMY02	1333528	S	3144	546	3690	0.00036
Streptomyces sp. MG28	2865673	S	3096	1450	4546	0.00044
Streptomyces sp. BJ20	2930049	S	3029	1335	4364	0.00042
Streptomyces sp. Go-475	2072505	S	3029	1641	4670	0.00045
Streptomyces sp. MBT27	1488356	S	3018	871	3889	0.00038
Streptomyces sp. 3025	2923272	S	2985	526	3511	0.00034
Streptomyces sp. jing01	2726118	S	2970	1917	4887	0.00047
Streptomyces sp. RTd22	1841249	S	2959	2402	5361	0.00052
Streptomyces sp. YIM 121038	2136401	S	2802	883	3685	0.00036
Streptomyces sp. 891-h	2720714	S	2795	508	3303	0.00032
Streptomyces sp. NA04227	2742136	S	2764	612	3376	0.00033
Streptomyces sp. SYP-A7193	2662065	S	2683	2402	5085	0.00049
Streptomyces sp. MST-110588	2833628	S	2664	633	3297	0.00032
Streptomyces sp. C8S0	2585716	S	2603	733	3336	0.00032
Streptomyces sp. CB09001	2083284	S	2584	2231	4815	0.00047
Streptomyces sp. GS7	2692234	S	2573	746	3319	0.00032
Streptomyces sp. S1D4-11	2721246	S	2510	2960	5470	0.00053
Streptomyces sp. Rer75	2750011	S	2505	2262	4767	0.00046
Streptomyces sp. S4.7	2705439	S	2444	868	3312	0.00032
Streptomyces sp. W1SF4	2305220	S	2425	922	3347	0.00032
Streptomyces sp. QHH-9511	2684468	S	2382	672	3054	0.00030
Streptomyces sp. BHT-5-2	2866715	S	2355	825	3180	0.00031
Streptomyces sp. SirexAA-E	862751	S	2339	826	3165	0.00031
Streptomyces sp. HP-A2021	2927875	S	2307	1491	3798	0.00037
Streptomyces sp. SM18	1736046	S	2257	734	2991	0.00029
Streptomyces sp. 135	2838850	S	2177	813	2990	0.00029
Streptomyces sp. CMB-StM0423	2059884	S	2153	2069	4222	0.00041
Streptomyces sp. HSG2	2797167	S	2050	413	2463	0.00024
Streptomyces sp. SUK 48	2582831	S	2043	1706	3749	0.00036
Streptomyces sp. Tu 2975	2676871	S	1958	641	2599	0.00025
Streptomyces sp. WAC 01529	2203205	S	1943	772	2715	0.00026
Streptomyces sp. fd1-xmd	1812480	S	1886	1169	3055	0.00030
Streptomyces sp. INR7	2607753	S	1757	1372	3129	0.00030
Streptomyces sp. HF10	2692233	S	1718	1631	3349	0.00032
Streptomyces sp. CCM_MD2014	1561022	S	1677	2686	4363	0.00042
Streptomyces sp. TN58	234612	S	1553	1037	2590	0.00025
Streptomyces sp. MOE7	1961713	S	1514	2030	3544	0.00034
Streptomyces sp. WY228	2855836	S	1420	931	2351	0.00023
Streptomyces sp. WAC 06738	2203210	S	1298	3035	4333	0.00042
Streptomyces sp. 2114.2	1881022	S	1275	9411	10686	0.00104
Streptomyces sp. CNQ-509	444103	S	1221	2782	4003	0.00039
Streptomyces sp. YPW6	2840373	S	1194	758	1952	0.00019
Streptomyces sp. 769	1262452	S	1190	1108	2298	0.00022
Streptomyces sp. XC 2026	2782004	S	1176	1138	2314	0.00022
Streptomyces sp. ADI95-16	1522758	S	1172	2164	3336	0.00032
Streptomyces sp. EAS-AB2608	2779671	S	1150	4055	5205	0.00050
Streptomyces sp. Mg1	465541	S	1148	2251	3399	0.00033
Streptomyces sp. PBH53	1577075	S	1077	3762	4839	0.00047
Streptomyces sp. M2	646637	S	1070	15835	16905	0.00164
Streptomyces sp. 11-1-2	1851167	S	1049	2358	3407	0.00033
Streptomyces hygroscopicus	1912	S	10182	16838	27020	0.00262
Streptomyces rapamycinicus	1226757	S	6528	1567	8095	0.00078
Streptomyces yatensis	155177	S	4956	3818	8774	0.00085
Streptomyces violaceusniger	68280	S	3119	2184	5303	0.00051
Streptomyces venezuelae	54571	S	14117	5055	19172	0.00186
Streptomyces cadmiisoli	2184053	S	3777	835	4612	0.00045
Streptomyces aurantiacus	47760	S	3539	762	4301	0.00042
Streptomyces qaidamensis	1783515	S	2236	908	3144	0.00030
Streptomyces alboniger	132473	S	1636	577	2213	0.00021
Streptomyces koyangensis	188770	S	1192	1207	2399	0.00023
Streptomyces bingchenggensis	379067	S	8404	1365	9769	0.00095
Streptomyces collinus	42684	S	8233	4768	13001	0.00126
Streptomyces lydicus	47763	S	8143	5664	13807	0.00134
Streptomyces asoensis	249586	S	7613	2047	9660	0.00094
Streptomyces chartreusis	1969	S	6922	2789	9711	0.00094
Streptomyces griseorubiginosus	67304	S	6258	1889	8147	0.00079
Streptomyces griseus	1911	S	2264	1966	4230	0.00041
Streptomyces anulatus	1892	S	1745	1958	3703	0.00036
Streptomyces griseochromogenes	68214	S	5695	1431	7126	0.00069
Streptomyces albus	1888	S	5608	2739	8347	0.00081
Streptomyces seoulensis	73044	S	5513	1833	7346	0.00071
Streptomyces aquilus	2548456	S	5507	1480	6987	0.00068
Streptomyces niveus	193462	S	5146	2121	7267	0.00070
Streptomyces actuosus	1885	S	4887	1835	6722	0.00065
Streptomyces formicae	1616117	S	4771	1395	6166	0.00060
Streptomyces antimycoticus	68175	S	4745	5369	10114	0.00098
Streptomyces phaeolivaceus	2653200	S	4621	1203	5824	0.00056
Streptomyces lincolnensis	1915	S	4603	1207	5810	0.00056
Streptomyces cattleya	29303	S	4495	1065	5560	0.00054
Streptomyces antibioticus	1890	S	4435	1402	5837	0.00057
Streptomyces buecherae	2763006	S	4325	903	5228	0.00051
Streptomyces tsukubensis	83656	S	4230	801	5031	0.00049
Streptomyces griseoviridis	45398	S	4207	1180	5387	0.00052
Streptomyces broussonetiae	2686304	S	3999	1093	5092	0.00049
Streptomyces davaonensis	348043	S	3989	1002	4991	0.00048
Streptomyces avermitilis	33903	S	3947	1010	4957	0.00048
Streptomyces spectabilis	68270	S	3872	1165	5037	0.00049
Streptomyces cyaneochromogenes	2496836	S	3844	1036	4880	0.00047
Streptomyces roseirectus	2768066	S	3770	802	4572	0.00044
Streptomyces galilaeus	33899	S	3764	1118	4882	0.00047
Streptomyces incarnatus	665007	S	3740	1083	4823	0.00047
Streptomyces capitiformicae	2014920	S	3663	561	4224	0.00041
Streptomyces ferrugineus	1413221	S	3658	1079	4737	0.00046
Streptomyces fodineus	1904616	S	3627	1187	4814	0.00047
Streptomyces xanthii	2768069	S	3494	902	4396	0.00043
Streptomyces roseochromogenus	285450	S	3464	992	4456	0.00043
Streptomyces nodosus	40318	S	3415	736	4151	0.00040
Streptomyces armeniacus	83291	S	3410	409	3819	0.00037
Streptomyces dangxiongensis	1442032	S	3333	1043	4376	0.00042
Streptomyces dengpaensis	2049881	S	3130	765	3895	0.00038
Streptomyces nigra	1827580	S	3111	1081	4192	0.00041
Streptomyces liangshanensis	2717324	S	3106	658	3764	0.00036
Streptomyces rimosus	1927	S	3096	13596	16692	0.00162
Streptomyces paludis	2282738	S	3066	563	3629	0.00035
Streptomyces bathyalis	2710756	S	3034	402	3436	0.00033
Streptomyces durmitorensis	319947	S	2981	561	3542	0.00034
Streptomyces glaucescens	1907	S	2921	1119	4040	0.00039
Streptomyces harbinensis	1176198	S	2917	665	3582	0.00035
Streptomyces ambofaciens	1889	S	2902	1564	4466	0.00043
Streptomyces vietnamensis	362257	S	2883	868	3751	0.00036
Streptomyces cyanogenus	80860	S	2880	1191	4071	0.00039
Streptomyces calvus	67282	S	2830	1019	3849	0.00037
Streptomyces albulus	68570	S	2829	764	3593	0.00035
Streptomyces prasinus	67345	S	2789	796	3585	0.00035
Streptomyces genisteinicus	2768068	S	2750	733	3483	0.00034
Streptomyces parvulus	146923	S	2736	1096	3832	0.00037
Streptomyces xinghaiensis	1038928	S	2735	681	3416	0.00033
Streptomyces aureoverticillatus	66871	S	2665	645	3310	0.00032
Streptomyces pluripotens	1355015	S	2656	522	3178	0.00031
Streptomyces chromofuscus	42881	S	2654	916	3570	0.00035
Streptomyces pactum	68249	S	2630	975	3605	0.00035
Streptomyces coelicolor	1902	S	2220	27517	29737	0.00288
Streptomyces alboflavus	67267	S	2610	645	3255	0.00032
Streptomyces viridosporus	67581	S	2569	942	3511	0.00034
Streptomyces olivoreticuli	68246	S	2567	616	3183	0.00031
Streptomyces globosus	68209	S	2551	792	3343	0.00032
Streptomyces atratus	1893	S	2533	443	2976	0.00029
Streptomyces clavuligerus	1901	S	2531	504	3035	0.00029
Streptomyces lunaelactis	1535768	S	2479	449	2928	0.00028
Streptomyces griseocarneus	51201	S	2462	725	3187	0.00031
Streptomyces fagopyri	2662397	S	2420	773	3193	0.00031
Streptomyces rectiverticillatus	173860	S	2411	652	3063	0.00030
Streptomyces hundungensis	1077946	S	2398	641	3039	0.00029
Streptomyces luteoverticillatus	66425	S	2390	664	3054	0.00030
Streptomyces tendae	1932	S	2385	887	3272	0.00032
Streptomyces deccanensis	424188	S	2384	982	3366	0.00033
Streptomyces ficellus	1977088	S	2376	727	3103	0.00030
Streptomyces peucetius	1950	S	2204	520	2724	0.00026
Streptomyces gilvosporeus	553510	S	2202	606	2808	0.00027
Streptomyces subrutilus	36818	S	2193	711	2904	0.00028
Streptomyces exfoliatus	1905	S	2159	652	2811	0.00027
Streptomyces lavendulae	1914	S	2139	660	2799	0.00027
Streptomyces kanamyceticus	1967	S	2138	696	2834	0.00027
Streptomyces katrae	68223	S	2073	683	2756	0.00027
Streptomyces coeruleorubidus	116188	S	2060	969	3029	0.00029
Streptomyces pratensis	1169025	S	2056	450	2506	0.00024
Streptomyces pristinaespiralis	38300	S	2052	682	2734	0.00027
Streptomyces vinaceus	1960	S	2027	644	2671	0.00026
Streptomyces nitrosporeus	28894	S	1927	474	2401	0.00023
Streptomyces finlayi	67296	S	1925	379	2304	0.00022
Streptomyces mobaraensis	35621	S	1914	84378	86292	0.00836
Streptomyces hawaiiensis	67305	S	1903	805	2708	0.00026
Streptomyces tuirus	68278	S	1890	895	2785	0.00027
Streptomyces inhibens	2293571	S	1885	522	2407	0.00023
Streptomyces gardneri	66892	S	1855	724	2579	0.00025
Streptomyces spongiicola	1690221	S	1851	651	2502	0.00024
Streptomyces huasconensis	1854574	S	1789	652	2441	0.00024
Streptomyces qinzhouensis	2599401	S	1785	373	2158	0.00021
Streptomyces tirandamycinicus	2174846	S	1750	517	2267	0.00022
Streptomyces angustmyceticus	285578	S	1745	651	2396	0.00023
Streptomyces rutgersensis	53451	S	1728	755	2483	0.00024
Streptomyces nojiriensis	66374	S	1658	681	2339	0.00023
Streptomyces leeuwenhoekii	1437453	S	1546	1077	2623	0.00025
Streptomyces gobiensis	2875706	S	1454	219	1673	0.00016
Streptomyces xiamenensis	408015	S	1363	1243	2606	0.00025
Streptomyces cyaneogriseus	68192	S	1348	1041	2389	0.00023
Streptomyces lividans	1916	S	1199	6573	7772	0.00075
Kitasatospora sp. NA04385	2742135	S	4775	2131	6906	0.00067
Kitasatospora sp. MMS16-BH015	2018025	S	3827	1049	4876	0.00047
Kitasatospora aureofaciens	1894	S	5307	1847	7154	0.00069
Kitasatospora setae	2066	S	4291	1846	6137	0.00059
Streptacidiphilus sp. P02-A3a	2704468	S	3629	933	4562	0.00044
Streptacidiphilus sp. PB12-B1b	2705012	S	2960	976	3936	0.00038
Streptacidiphilus bronchialis	2126346	S	3779	1025	4804	0.00047
Yinghuangia sp. ASG 101	2896848	S	9306	1266	10572	0.00102
Microbacterium sp. No. 7	1714373	S	2694	1150	3844	0.00037
Microbacterium sp. 4R-513	2567934	S	2661	516	3177	0.00031
Microbacterium sp. SSW1-51	2851650	S	2147	878	3025	0.00029
Microbacterium sp. 10M-3C3	2483401	S	2026	1222	3248	0.00031
Microbacterium sp. YJN-G	2763257	S	1928	800	2728	0.00026
Microbacterium sp. CBA3102	2603598	S	1869	873	2742	0.00027
Microbacterium sp. JZ31	1906274	S	1868	515	2383	0.00023
Microbacterium sp. Y-01	2048898	S	1744	1182	2926	0.00028
Microbacterium sp. SSW1-36	2851648	S	1671	533	2204	0.00021
Microbacterium sp. XT11	367477	S	1665	423	2088	0.00020
Microbacterium sp. ABRD_28	2268461	S	1631	232	1863	0.00018
Microbacterium sp. TPU 3598	1938334	S	1529	809	2338	0.00023
Microbacterium sp. A18JL241	2782166	S	1527	452	1979	0.00019
Microbacterium sp. BH-3-3-3	1906742	S	1525	380	1905	0.00018
Microbacterium sp. H1-D42	2925844	S	1453	285	1738	0.00017
Microbacterium sp. NIBRBAC000506063	2734618	S	1450	574	2024	0.00020
Microbacterium sp. cx-55	2875948	S	1412	212	1624	0.00016
Microbacterium sp. PM5	2014534	S	1330	266	1596	0.00015
Microbacterium sp. LKL04	912630	S	1206	302	1508	0.00015
Microbacterium sp. 1S1	2606451	S	1080	1091	2171	0.00021
Microbacterium sp. Nx66	2766784	S	1009	1524	2533	0.00025
Microbacterium foliorum	104336	S	3367	704	4071	0.00039
Microbacterium cremeum	2782169	S	3241	610	3851	0.00037
Microbacterium atlanticum	2782168	S	2924	570	3494	0.00034
Microbacterium hominis	162426	S	2836	10470	13306	0.00129
Microbacterium oleivorans	273677	S	2355	415	2770	0.00027
Microbacterium resistens	156977	S	2256	364	2620	0.00025
Microbacterium lemovicicum	1072463	S	2020	404	2424	0.00024
Microbacterium pygmaeum	370764	S	1763	194	1957	0.00019
Microbacterium sediminis	904291	S	1704	693	2397	0.00023
Microbacterium oxydans	82380	S	1618	1537	3155	0.00031
Microbacterium testaceum	2033	S	1561	258	1819	0.00018
Microbacterium aurum	36805	S	1551	449	2000	0.00019
Microbacterium caowuchunii	2614638	S	1528	252	1780	0.00017
Microbacterium oryzae	743009	S	1519	384	1903	0.00018
Microbacterium protaetiae	2509458	S	1452	276	1728	0.00017
Microbacterium wangchenii	2541726	S	1414	312	1726	0.00017
Microbacterium esteraromaticum	57043	S	1355	282	1637	0.00016
Microbacterium chocolatum	84292	S	1346	265	1611	0.00016
Microbacterium lushaniae	2614639	S	1344	302	1646	0.00016
Microbacterium luteum	2782167	S	1331	502	1833	0.00018
Microbacterium hydrocarbonoxydans	273678	S	1149	205	1354	0.00013
Microbacterium schleiferi	69362	S	1004	308	1312	0.00013
Leifsonia sp. 21MFCrub1.1	1798223	S	10369	9942	20311	0.00197
Leifsonia sp. ZF2019	2781978	S	8057	1997	10054	0.00097
Leifsonia sp. PS1209	2724914	S	7310	1818	9128	0.00088
Leifsonia shinshuensis	150026	S	15117	4158	19275	0.00187
Leifsonia xyli	1575	S	3450	436	3886	0.00038
Agromyces sp. H17E-10	2932244	S	9302	2725	12027	0.00117
Agromyces sp. LHK192	2498704	S	2104	542	2646	0.00026
Agromyces sp. CFWR-12	2929802	S	1791	932	2723	0.00026
Agromyces soli	659012	S	2275	744	3019	0.00029
Agromyces flavus	589382	S	2067	585	2652	0.00026
Agromyces aureus	453304	S	2054	522	2576	0.00025
Agromyces protaetiae	2509455	S	1840	469	2309	0.00022
Agromyces archimandritae	2781962	S	1712	437	2149	0.00021
Agromyces marinus	1389020	S	1564	507	2071	0.00020
Agromyces intestinalis	2592652	S	1519	756	2275	0.00022
Agromyces badenianii	2080742	S	1415	416	1831	0.00018
Agromyces laixinhei	2585717	S	1303	267	1570	0.00015
Curtobacterium sp. BH-2-1-1	1905847	S	1480	1366	2846	0.00028
Curtobacterium sp. L6-1	2841594	S	1309	813	2122	0.00021
Curtobacterium sp. MR_MD2014	1561023	S	1034	2170	3204	0.00031
Curtobacterium flaccumfaciens	2035	S	2199	1211	3410	0.00033
Curtobacterium luteum	33881	S	1323	528	1851	0.00018
Rathayibacter sp. VKM Ac-2759	2609252	S	1782	819	2601	0.00025
Rathayibacter sp. VKM Ac-2760	2609253	S	1517	1373	2890	0.00028
Rathayibacter sp. VKM Ac-2804	2609257	S	1098	1432	2530	0.00025
Rathayibacter festucae	110937	S	1664	1978	3642	0.00035
Rathayibacter tanaceti	1671680	S	1075	272	1347	0.00013
Protaetiibacter sp. SSC-01	2759943	S	4452	1612	6064	0.00059
Protaetiibacter intestinalis	2419774	S	3803	1346	5149	0.00050
Protaetiibacter larvae	2592654	S	2329	722	3051	0.00030
Clavibacter michiganensis	28447	S	7379	7257	14636	0.00142
Leucobacter sp. H25R-14	2932245	S	1166	1163	2329	0.00023
Leucobacter sp. NB 10	2873270	S	1081	619	1700	0.00016
Leucobacter muris	1935379	S	1296	465	1761	0.00017
Leucobacter triazinivorans	1784719	S	1205	605	1810	0.00018
Agrococcus sp. SGAir0287	2070347	S	1765	512	2277	0.00022
Agrococcus sp. SCSIO52902	2933290	S	1549	715	2264	0.00022
Agrococcus sp. Marseille-Q4369	2810513	S	1528	515	2043	0.00020
Agrococcus jejuensis	399736	S	1829	549	2378	0.00023
Agrococcus carbonis	684552	S	1656	716	2372	0.00023
Salinibacterium sp. ZJ70	2708084	S	1613	412	2025	0.00020
Salinibacterium sp. ZJ450	2708338	S	1294	204	1498	0.00015
Cryobacterium sp. LW097	1978566	S	1129	1213	2342	0.00023
Frondihabitans sp. PAMC 28766	1795630	S	1812	225	2037	0.00020
Frondihabitans sp. 762G35	1446794	S	1472	295	1767	0.00017
Microterricola viridarii	412690	S	3115	712	3827	0.00037
Humibacter sp. WJ7-1	2599293	S	2857	583	3440	0.00033
Microcella flavibacter	1804990	S	1678	762	2440	0.00024
Cnuibacter physcomitrellae	1619308	S	2189	443	2632	0.00026
Herbiconiux sp. SALV-R1	2735133	S	2188	409	2597	0.00025
Gryllotalpicola protaetiae	2419771	S	2042	362	2404	0.00023
Subtercola sp. AK-R2A1-2	2895559	S	1142	97	1239	0.00012
Frigoribacterium sp. NBH87	2596916	S	1842	506	2348	0.00023
Amnibacterium sp. L3-i23	2905871	S	1487	330	1817	0.00018
Marisediminicola antarctica	674079	S	1217	138	1355	0.00013
Gulosibacter sediminis	1729695	S	1045	270	1315	0.00013
Glaciihabitans sp. INWT7	2596912	S	1045	76	1121	0.00011
Arthrobacter sp. NicSoilC5	2831000	S	13566	5860	19426	0.00188
Arthrobacter sp. FW305-BF8	2879617	S	3920	939	4859	0.00047
Arthrobacter sp. QXT-31	1357915	S	3378	825	4203	0.00041
Arthrobacter sp. FW306-06-A	2879621	S	3089	8781	11870	0.00115
Arthrobacter sp. NicSoilB8	2830998	S	2544	583	3127	0.00030
Arthrobacter sp. PM3	2017685	S	2262	328	2590	0.00025
Arthrobacter sp. PAMC25564	2565366	S	2231	534	2765	0.00027
Arthrobacter sp. 24S4-2	2575374	S	2097	410	2507	0.00024
Arthrobacter sp. UKPF54-2	2600159	S	2020	751	2771	0.00027
Arthrobacter sp. KBS0702	2578107	S	1976	692	2668	0.00026
Arthrobacter sp. U41	1849032	S	1856	459	2315	0.00022
Arthrobacter sp. FW306-07-I	2879622	S	1849	8374	10223	0.00099
Arthrobacter sp. PGP41	2079227	S	1824	532	2356	0.00023
Arthrobacter sp. FB24	290399	S	1809	490	2299	0.00022
Arthrobacter sp. NicSoilB4	2830997	S	1765	488	2253	0.00022
Arthrobacter sp. FW306-05-C	2879620	S	1762	7478	9240	0.00090
Arthrobacter sp. QL17	2895818	S	1729	474	2203	0.00021
Arthrobacter sp. ERGS1:01	1704044	S	1707	371	2078	0.00020
Arthrobacter sp. Helios	2828862	S	1565	264	1829	0.00018
Arthrobacter sp. PAMC25284	2861279	S	1521	339	1860	0.00018
Arthrobacter sp. FW306-2-2C-D06B	2879618	S	1453	245	1698	0.00016
Arthrobacter sp. zg-Y462	2886936	S	1402	315	1717	0.00017
Arthrobacter sp. zg-Y809	2886940	S	1040	818	1858	0.00018
Arthrobacter crystallopoietes	37928	S	5995	1090	7085	0.00069
Arthrobacter sulfonylureivorans	2486855	S	4005	662	4667	0.00045
Arthrobacter agilis	37921	S	2475	446	2921	0.00028
Arthrobacter dokdonellae	2211210	S	1591	316	1907	0.00018
Arthrobacter woluwensis	156980	S	1474	322	1796	0.00017
Arthrobacter jiangjiafuii	2817475	S	1231	505	1736	0.00017
Sinomonas atrocyanea	37927	S	29898	7988	37886	0.00367
Sinomonas sp. R1AF57	2020377	S	4081	782	4863	0.00047
Pseudarthrobacter sp. NIBRBAC000502771	2590774	S	1354	3766	5120	0.00050
Pseudarthrobacter sp. NIBRBAC000502770	2590785	S	1350	3346	4696	0.00046
Pseudarthrobacter sp. BIM B-2242	2772401	S	1273	307	1580	0.00015
Pseudarthrobacter sp. L1SW	2851598	S	1243	553	1796	0.00017
Pseudarthrobacter chlorophenolicus	85085	S	1324	741	2065	0.00020
Pseudarthrobacter phenanthrenivorans	361575	S	1215	612	1827	0.00018
Pseudarthrobacter equi	728066	S	1176	722	1898	0.00018
Kocuria rosea	1275	S	1840	1044	2884	0.00028
Kocuria flava	446860	S	1718	1121	2839	0.00028
Kocuria turfanensis	388357	S	1577	1100	2677	0.00026
Micrococcus luteus	1270	S	2190	3319	5509	0.00053
Rothia kristinae	37923	S	1099	583	1682	0.00016
Citricoccus sp. SGAir0253	2567881	S	1833	413	2246	0.00022
Cellulomonas sp. Y8	2591145	S	2644	1072	3716	0.00036
Cellulomonas sp. H30R-01	2704467	S	2559	961	3520	0.00034
Cellulomonas sp. JZ18	2654191	S	2223	908	3131	0.00030
Cellulomonas sp. C5510	2871170	S	2204	841	3045	0.00030
Cellulomonas sp. zg-ZUI188	2819978	S	2059	542	2601	0.00025
Cellulomonas sp. zg-ZUI222	2816956	S	1823	656	2479	0.00024
Cellulomonas sp. zg-ZUI157	2819979	S	1779	594	2373	0.00023
Cellulomonas sp. EW123	2608402	S	1622	946	2568	0.00025
Cellulomonas sp. PSBB021	2003551	S	1547	1216	2763	0.00027
Cellulomonas fimi	1708	S	2266	1736	4002	0.00039
Cellulomonas iranensis	76862	S	2060	919	2979	0.00029
Cellulomonas shaoxiangyii	2566013	S	1988	783	2771	0.00027
Cellulomonas flavigena	1711	S	1828	666	2494	0.00024
Cellulomonas gilvus	11	S	1755	732	2487	0.00024
Cellulomonas taurus	2729175	S	1481	435	1916	0.00019
Actinotalea sp. JY-7876	2758442	S	2126	712	2838	0.00028
Oerskovia sp. KBS0722	1179673	S	1594	472	2066	0.00020
Pseudactinotalea sp. HY158	2654547	S	1535	200	1735	0.00017
Paraoerskovia marina	545619	S	1114	265	1379	0.00013
Intrasporangium calvum	53358	S	9861	2261	12122	0.00118
Janibacter melonis	262209	S	3084	1514	4598	0.00045
Janibacter limosus	53458	S	1888	1696	3584	0.00035
Phycicoccus sp. HDW14	2714941	S	4280	1382	5662	0.00055
Phycicoccus endophyticus	1690220	S	3007	865	3872	0.00038
Pedococcus dokdonensis	443156	S	5279	1542	6821	0.00066
Tetrasphaera sp. HKS02	1813880	S	4388	1132	5520	0.00054
Arsenicicoccus sp. oral taxon 190	1658671	S	2527	898	3425	0.00033
Cellulosimicrobium cellulans	1710	S	7679	7459	15138	0.00147
Cellulosimicrobium sp. BI34T	2587808	S	1834	945	2779	0.00027
Xylanimonas protaetiae	2509457	S	1872	759	2631	0.00026
Xylanimonas cellulosilytica	186189	S	1585	518	2103	0.00020
Xylanimonas allomyrinae	2509459	S	1548	447	1995	0.00019
Isoptericola variabilis	139208	S	1915	915	2830	0.00027
Isoptericola dokdonensis	372663	S	1861	653	2514	0.00024
Ornithinimicrobium avium	2283195	S	2214	538	2752	0.00027
Ornithinimicrobium sp. HY006	2508882	S	1616	521	2137	0.00021
Ornithinimicrobium flavum	1288636	S	1806	552	2358	0.00023
Ornithinimicrobium ciconiae	2594265	S	1431	200	1631	0.00016
Ornithinimicrobium pratense	2593973	S	1122	305	1427	0.00014
Serinicoccus chungangensis	767452	S	1669	521	2190	0.00021
Serinicoccus hydrothermalis	1758689	S	1518	642	2160	0.00021
Serinicoccus profundi	1078471	S	1486	488	1974	0.00019
Serinicoccus marinus	247333	S	1332	591	1923	0.00019
Brachybacterium sp. CBA3105	2887346	S	1640	353	1993	0.00019
Brachybacterium sp. SGAir0954	2571029	S	1497	404	1901	0.00018
Brachybacterium sp. P6-10-X1	1903186	S	1331	237	1568	0.00015
Brachybacterium saurashtrense	556288	S	1313	412	1725	0.00017
Brachybacterium ginsengisoli	1331682	S	1274	426	1700	0.00016
Brachybacterium faecium	43669	S	1107	385	1492	0.00014
Brevibacterium sp. CS2	2575923	S	1304	528	1832	0.00018
Brevibacterium casei	33889	S	1511	3080	4591	0.00045
Dermacoccus nishinomiyaensis	1274	S	1721	728	2449	0.00024
Dermacoccus sp. PAMC28757	2762331	S	1134	419	1553	0.00015
Luteipulveratus mongoliensis	571913	S	2392	309	2701	0.00026
Allobranchiibius sp. GilTou73	2904523	S	1900	385	2285	0.00022
Yimella sp. cx-51	2770551	S	1065	195	1260	0.00012
Georgenia yuyongxinii	2589797	S	2113	467	2580	0.00025
Georgenia sp. TF02-10	2917725	S	2075	694	2769	0.00027
Georgenia wutianyii	2585135	S	1869	586	2455	0.00024
Georgenia faecalis	2483799	S	1790	451	2241	0.00022
Haloactinobacterium kanbiaonis	2675754	S	2210	314	2524	0.00024
Ruania sp. LR1S40	2897774	S	1192	311	1503	0.00015
Ruania zhangjianzhongii	2603206	S	1338	136	1474	0.00014
Beutenbergia cavernae	84757	S	2718	412	3130	0.00030
Miniimonas sp. S16	2171623	S	1896	921	2817	0.00027
Pengzhenrongella sicca	2819238	S	2292	585	2877	0.00028
Luteimicrobium xylanilyticum	1133546	S	2178	619	2797	0.00027
Sanguibacter keddieii	60920	S	1747	472	2219	0.00022
Sanguibacter sp. HDW7	2714931	S	1499	425	1924	0.00019
Kytococcus sedentarius	1276	S	1429	467	1896	0.00018
Pseudonocardia sp. DSM 110487	2865833	S	69653	8774	78427	0.00760
Pseudonocardia sp. CGMCC 4.1532	2761535	S	6205	3327	9532	0.00092
Pseudonocardia sp. HH130630-07	1690815	S	4719	3520	8239	0.00080
Pseudonocardia sp. AL041005-10	445576	S	3842	2737	6579	0.00064
Pseudonocardia sp. HH130629-09	1641402	S	3194	4010	7204	0.00070
Pseudonocardia dioxanivorans	240495	S	13887	3272	17159	0.00166
Pseudonocardia broussonetiae	2736640	S	8934	2663	11597	0.00112
Pseudonocardia autotrophica	2074	S	5033	1211	6244	0.00061
Pseudonocardia abyssalis	2792008	S	4748	2245	6993	0.00068
Amycolatopsis sp. FU40	2914159	S	9211	2874	12085	0.00117
Amycolatopsis sp. DSM 110486	2865832	S	7634	1235	8869	0.00086
Amycolatopsis sp. WQ 127309	2932773	S	7392	1716	9108	0.00088
Amycolatopsis sp. Hca4	2742131	S	7018	2144	9162	0.00089
Amycolatopsis sp. AA4	1896961	S	5329	1943	7272	0.00070
Amycolatopsis sp. FDAARGOS 1241	2778070	S	5300	934	6234	0.00060
Amycolatopsis sp. CA-230715	2745196	S	4195	552	4747	0.00046
Amycolatopsis sp. YIM 10	2653857	S	3558	894	4452	0.00043
Amycolatopsis sp. BJA-103	1911175	S	2093	682	2775	0.00027
Amycolatopsis sp. TNS106	2861750	S	1663	788	2451	0.00024
Amycolatopsis sp. EV170708-02-1	2919322	S	1397	1135	2532	0.00025
Amycolatopsis pretoriensis	218821	S	10201	2820	13021	0.00126
Amycolatopsis mediterranei	33910	S	6572	6584	13156	0.00128
Amycolatopsis acidiphila	715473	S	5490	1024	6514	0.00063
Amycolatopsis keratiniphila	129921	S	2174	1587	3761	0.00036
Amycolatopsis japonica	208439	S	1120	937	2057	0.00020
Amycolatopsis methanolica	1814	S	3616	1241	4857	0.00047
Amycolatopsis thermalba	944492	S	3613	1305	4918	0.00048
Amycolatopsis albispora	1804986	S	3164	1599	4763	0.00046
Amycolatopsis aidingensis	2842453	S	2804	291	3095	0.00030
Amycolatopsis orientalis	31958	S	2251	657	2908	0.00028
Saccharopolyspora erythraea	1836	S	5798	1570	7368	0.00071
Saccharopolyspora gregorii	33914	S	3701	667	4368	0.00042
Saccharopolyspora spinosa	60894	S	1457	1056	2513	0.00024
Saccharopolyspora pogona	333966	S	1286	1873	3159	0.00031
Saccharothrix syringae	103733	S	4976	1548	6524	0.00063
Saccharothrix sp. 6-C	2781735	S	4174	1278	5452	0.00053
Saccharothrix espanaensis	103731	S	3967	1046	5013	0.00049
Kutzneria sp. CA-103260	2802641	S	6152	1167	7319	0.00071
Kutzneria albida	43357	S	3933	799	4732	0.00046
Saccharomonospora marina	632569	S	2166	464	2630	0.00025
Saccharomonospora azurea	40988	S	1594	469	2063	0.00020
Saccharomonospora cyanea	40989	S	1372	489	1861	0.00018
Saccharomonospora xinjiangensis	75294	S	1229	190	1419	0.00014
Saccharomonospora glauca	40990	S	1060	376	1436	0.00014
Actinoalloteichus hymeniacidonis	340345	S	4336	1144	5480	0.00053
Actinoalloteichus hoggarensis	1470176	S	1832	1391	3223	0.00031
Actinosynnema pretiosum	42197	S	1665	4414	6079	0.00059
Allokutzneria albata	211114	S	4931	1039	5970	0.00058
Lentzea guizhouensis	1586287	S	4182	774	4956	0.00048
Kibdelosporangium phytohabitans	860235	S	3844	409	4253	0.00041
Alloactinosynnema sp. L-07	1653480	S	2920	570	3490	0.00034
Prauserella marina	530584	S	1947	155	2102	0.00020
Allosaccharopolyspora coralli	2665642	S	1494	284	1778	0.00017
Micromonospora sp. WMMC415	2675222	S	3107	1019	4126	0.00040
Micromonospora sp. WMMA2032	2039870	S	2693	1564	4257	0.00041
Micromonospora sp. HM134	2583243	S	2614	1035	3649	0.00035
Micromonospora sp. B006	2201999	S	2298	1605	3903	0.00038
Micromonospora terminaliae	1914461	S	10161	4514	14675	0.00142
Micromonospora inositola	47865	S	3854	1675	5529	0.00054
Micromonospora carbonacea	47853	S	3623	1406	5029	0.00049
Micromonospora krabiensis	307121	S	3554	1067	4621	0.00045
Micromonospora viridifaciens	1881	S	3423	1318	4741	0.00046
Micromonospora auratinigra	261654	S	3345	1553	4898	0.00047
Micromonospora echinofusca	47858	S	3343	1329	4672	0.00045
Micromonospora echinaurantiaca	47857	S	3255	1384	4639	0.00045
Micromonospora ferruginea	2749844	S	2976	1522	4498	0.00044
Micromonospora echinospora	1877	S	2975	915	3890	0.00038
Micromonospora purpureochromogenes	47872	S	2948	1373	4321	0.00042
Micromonospora narathiwatensis	299146	S	2937	1220	4157	0.00040
Micromonospora coriariae	285665	S	2891	908	3799	0.00037
Micromonospora siamensis	299152	S	2882	1209	4091	0.00040
Micromonospora coxensis	356852	S	2747	1340	4087	0.00040
Micromonospora sagamiensis	47875	S	2545	859	3404	0.00033
Micromonospora maris	1003110	S	2441	654	3095	0.00030
Micromonospora zamorensis	709883	S	2421	686	3107	0.00030
Micromonospora endophytica (Xie et al. 2001) Li et al. 2019	515350	S	2355	635	2990	0.00029
Micromonospora rifamycinica	291594	S	2316	920	3236	0.00031
Micromonospora chokoriensis	356851	S	2284	652	2936	0.00028
Micromonospora craniellae	2294034	S	1797	1034	2831	0.00027
Micromonospora tulbaghiae	479978	S	1526	1499	3025	0.00029
Micromonospora aurantiaca	47850	S	1256	7929	9185	0.00089
Actinoplanes sp. L3-i22	2836373	S	10266	6897	17163	0.00166
Actinoplanes sp. N902-109	649831	S	7923	2161	10084	0.00098
Actinoplanes sp. OR16	946334	S	7130	3161	10291	0.00100
Actinoplanes ianthinogenes	122358	S	7579	2817	10396	0.00101
Actinoplanes friuliensis	196914	S	7459	1085	8544	0.00083
Actinoplanes derwentensis	113562	S	6648	918	7566	0.00073
Actinoplanes missouriensis	1866	S	6172	1865	8037	0.00078
Actinoplanes teichomyceticus	1867	S	6099	2365	8464	0.00082
Dactylosporangium vinaceum	53362	S	16694	1645	18339	0.00178
Phytohabitans suffuscus	624315	S	6072	1372	7444	0.00072
Phytohabitans flavus	1076124	S	4761	826	5587	0.00054
Plantactinospora sp. KBS50	2024580	S	3897	4636	8533	0.00083
Actinocatenispora thailandica	227318	S	3993	989	4982	0.00048
Actinocatenispora sera	390989	S	3859	1007	4866	0.00047
Couchioplanes caeruleus	56438	S	7406	1704	9110	0.00088
Catellatospora sp. IY07-71	2728827	S	6418	1249	7667	0.00074
Polymorphospora rubra	338584	S	4181	830	5011	0.00049
Natronosporangium hydrolyticum	2811111	S	2408	142	2550	0.00025
Verrucosispora sp. NA02020	2742132	S	1842	1337	3179	0.00031
Salinispora tropica	168695	S	1440	218	1658	0.00016
Nocardioides sp. G188	2849501	S	6723	1886	8609	0.00083
Nocardioides sp. LMS-CY	2840457	S	5076	1528	6604	0.00064
Nocardioides sp. JS614	196162	S	4786	1303	6089	0.00059
Nocardioides sp. TF02-7	2917724	S	3887	1158	5045	0.00049
Nocardioides sp. W7	2931390	S	3732	1163	4895	0.00047
Nocardioides sp. S5	2017486	S	3517	1637	5154	0.00050
Nocardioides sp. S-1144	2582905	S	3448	1217	4665	0.00045
Nocardioides sp. zg-1228	2763008	S	3402	1372	4774	0.00046
Nocardioides sp. HDW12B	2714939	S	3270	978	4248	0.00041
Nocardioides sp. zg-579	2663857	S	3258	1513	4771	0.00046
Nocardioides sp. cx-173	2898796	S	3136	987	4123	0.00040
Nocardioides sp. 603	2483798	S	2876	1221	4097	0.00040
Nocardioides sp. InS609-2	2760705	S	2702	571	3273	0.00032
Nocardioides sp. Kera G14	2884264	S	2558	486	3044	0.00030
Nocardioides sp. zg-536	2803858	S	2557	1018	3575	0.00035
Nocardioides sp. SCSIO 67246	2872154	S	2490	604	3094	0.00030
Nocardioides sp. CF8	110319	S	2477	954	3431	0.00033
Nocardioides sp. WS12	2486272	S	2372	383	2755	0.00027
Nocardioides sp. MC1495	2736757	S	2359	768	3127	0.00030
Nocardioides sp. JQ2195	2592334	S	2135	408	2543	0.00025
Nocardioides sp. dk884	2662361	S	2040	1961	4001	0.00039
Nocardioides sp. ZJ1313	2685869	S	1953	1892	3845	0.00037
Nocardioides humi	449461	S	6494	2016	8510	0.00083
Nocardioides ungokensis	1643322	S	5195	1690	6885	0.00067
Nocardioides cynanchi	2558918	S	5162	1129	6291	0.00061
Nocardioides aromaticivorans	200618	S	4593	1624	6217	0.00060
Nocardioides anomalus	2712223	S	4384	1230	5614	0.00054
Nocardioides mesophilus	433659	S	4150	1152	5302	0.00051
Nocardioides okcheonensis	2894081	S	3656	1561	5217	0.00051
Nocardioides dongkuii	2760089	S	3036	1405	4441	0.00043
Nocardioides euryhalodurans	2518370	S	2962	839	3801	0.00037
Nocardioides aquaticus	160826	S	2789	793	3582	0.00035
Nocardioides marinisabuli	419476	S	2688	1395	4083	0.00040
Nocardioides rotundus	1774216	S	2674	955	3629	0.00035
Nocardioides sambongensis	2589074	S	2496	661	3157	0.00031
Nocardioides dokdonensis	450734	S	2362	1036	3398	0.00033
Nocardioides seonyuensis	2518371	S	2062	515	2577	0.00025
Nocardioides panacisoli	627624	S	1992	453	2445	0.00024
Nocardioides houyundeii	2045452	S	1938	548	2486	0.00024
Nocardioides piscis	2714938	S	1850	661	2511	0.00024
Nocardioides daphniae	402297	S	1642	698	2340	0.00023
Nocardioides jishulii	2575440	S	1317	447	1764	0.00017
Nocardioides baekrokdamisoli	1804624	S	1249	143	1392	0.00013
Nocardioides yefusunii	2500546	S	1079	288	1367	0.00013
Aeromicrobium sp. Leaf245	1736306	S	1713	468	2181	0.00021
Aeromicrobium sp. zg-629	2663859	S	1373	398	1771	0.00017
Aeromicrobium sp. A1-2	2107713	S	1238	154	1392	0.00014
Aeromicrobium erythreum	2041	S	1909	507	2416	0.00023
Aeromicrobium chenweiae	2079793	S	1862	555	2417	0.00023
Aeromicrobium choanae	1736691	S	1742	465	2207	0.00021
Aeromicrobium yanjiei	2662028	S	1629	449	2078	0.00020
Aeromicrobium marinum	219314	S	1378	270	1648	0.00016
Pimelobacter simplex	2045	S	4900	1698	6598	0.00064
Marmoricola scoriae	642780	S	2974	1031	4005	0.00039
Friedmanniella luteola	546871	S	2829	523	3352	0.00033
Mumia sp. ZJ1417	2708082	S	2130	335	2465	0.00024
Micropruina glycogenica	75385	S	1177	156	1333	0.00013
Microlunatus sagamiharensis	546874	S	2917	628	3545	0.00034
Microlunatus soli	630515	S	2180	200	2380	0.00023
Microlunatus elymi	2596828	S	1874	191	2065	0.00020
Microlunatus sp. Gsoil 973	2672569	S	1649	119	1768	0.00017
Microlunatus phosphovorus	29405	S	1522	166	1688	0.00016
Tessaracoccus sp. J1M15	2829499	S	1140	448	1588	0.00015
Tessaracoccus aquimaris	1332264	S	1181	777	1958	0.00019
Tessaracoccus defluvii	1285901	S	1158	1186	2344	0.00023
Brevilactibacter coleopterorum	2714937	S	1552	687	2239	0.00022
Brevilactibacter sp. MC1595	2819349	S	1517	579	2096	0.00020
Acidipropionibacterium acidipropionici	1748	S	1076	735	1811	0.00018
Auraticoccus monumenti	675864	S	2058	348	2406	0.00023
Raineyella fluvialis	2662261	S	1295	160	1455	0.00014
Kribbella flavida	182640	S	10653	2264	12917	0.00125
Kribbella qitaiheensis	1544730	S	8933	1289	10222	0.00099
Actinopolymorpha singaporensis	117157	S	4853	486	5339	0.00052
Actinomadura verrucosospora	46165	S	51332	12543	63875	0.00619
Actinomadura sp. NAK00032	2742128	S	16904	4756	21660	0.00210
Actinomadura sp. WMMA1423	2591108	S	11582	2737	14319	0.00139
Actinomadura sp. WMMB 499	1219491	S	7133	1404	8537	0.00083
Actinomadura madurae	1993	S	8342	1959	10301	0.00100
Actinomadura graeca	2750812	S	5934	1113	7047	0.00068
Thermomonospora amylolytica	1411117	S	4880	1580	6460	0.00063
Thermomonospora curvata	2020	S	3160	813	3973	0.00039
Nonomuraea coxensis	404386	S	13172	3494	16666	0.00162
Nonomuraea nitratireducens	2656914	S	9911	1979	11890	0.00115
Nonomuraea sp. ATCC 55076	1909395	S	8467	2637	11104	0.00108
Nonomuraea gerenzanensis	93944	S	7658	2512	10170	0.00099
Streptosporangium roseum	2001	S	25386	6277	31663	0.00307
Streptosporangium sp. 'caverna'	2202249	S	14177	2775	16952	0.00164
Thermobispora bispora	2006	S	3662	742	4404	0.00043
Nocardiopsis sp. MT53	2865672	S	2685	572	3257	0.00032
Nocardiopsis gilva	280236	S	2131	387	2518	0.00024
Nocardiopsis dassonvillei	2014	S	1523	2235	3758	0.00036
Nocardiopsis alba	53437	S	1456	238	1694	0.00016
Thermobifida alba	53522	S	1645	616	2261	0.00022
Thermobifida halotolerans	483545	S	1618	491	2109	0.00020
Streptomonospora litoralis	2498135	S	2340	413	2753	0.00027
Spiractinospora alimapuensis	2820884	S	1508	88	1596	0.00015
Blastococcus sp. PRF04-17	2933797	S	9476	2991	12467	0.00121
Blastococcus saxobsidens	138336	S	8044	2290	10334	0.00100
Modestobacter marinus	477641	S	8246	2653	10899	0.00106
Modestobacter sp. L9-4	2851567	S	5185	1831	7016	0.00068
Geodermatophilus obscurus	1861	S	8707	2714	11421	0.00111
Actinomyces radicidentis	111015	S	1052	2542	3594	0.00035
Frankia inefficax	298654	S	5887	603	6490	0.00063
Frankia sp. QA3	710111	S	2213	831	3044	0.00030
Frankia sp. ArI3	1858	S	1695	1010	2705	0.00026
Candidatus Frankia datiscae	2716812	S	2144	426	2570	0.00025
Frankia alni	1859	S	1910	1197	3107	0.00030
Frankia casuarinae	106370	S	1801	166	1967	0.00019
Catenulispora acidiphila	304895	S	11375	1430	12805	0.00124
Jiangella sp. DSM 45060	1798224	S	4257	1133	5390	0.00052
Jiangella alkaliphila	419479	S	4182	1069	5251	0.00051
Nakamurella multipartita	53461	S	5171	833	6004	0.00058
Nakamurella panacisegetis	1090615	S	1886	211	2097	0.00020
Nakamurella sp. PAMC28650	2762325	S	1715	146	1861	0.00018
Jatrophihabitans sp. GAS493	1907575	S	2609	218	2827	0.00027
Jatrophihabitans telluris	2038343	S	2447	193	2640	0.00026
Stackebrandtia nassauensis	283811	S	2221	177	2398	0.00023
Kineococcus radiotolerans	131568	S	2266	537	2803	0.00027
Epidermidibacterium keratini	1891644	S	1469	620	2089	0.00020
Actinopolyspora erythraea	414996	S	1249	109	1358	0.00013
Conexibacter sp. SYSU D00693	2812560	S	19592	4184	23776	0.00230
Conexibacter sp. S30A1	2937800	S	7128	703	7831	0.00076
Conexibacter sp. DBS9H8	2937801	S	6604	592	7196	0.00070
Conexibacter woesei	191495	S	30618	4755	35373	0.00343
Miltoncostaea oceani	2843216	S	7618	1016	8634	0.00084
Miltoncostaea marina	2843215	S	7126	1606	8732	0.00085
Baekduia soli	496014	S	25946	3612	29558	0.00287
Rubrobacter xylanophilus	49319	S	3425	366	3791	0.00037
Rubrobacter marinus	2653852	S	2203	173	2376	0.00023
Rubrobacter tropicus	2653851	S	1905	125	2030	0.00020
Rubrobacter radiotolerans	42256	S	1183	141	1324	0.00013
Aquihabitans sp. G128	2849779	S	8159	1345	9504	0.00092
Aquihabitans sp. Kera 3	2884263	S	5957	797	6754	0.00065
Iamia sp. SCSIO 61187	2722752	S	7364	949	8313	0.00081
Actinomarinicola tropica	2789776	S	5244	841	6085	0.00059
Ilumatobacter coccineus	467094	S	2455	125	2580	0.00025
Egibacter rhizosphaerae	1670831	S	2379	115	2494	0.00024
Euzebya pacifica	1608957	S	2163	145	2308	0.00022
Egicoccus halophilus	1670830	S	2085	264	2349	0.00023
Paenibacillus polymyxa	1406	S	1026738	198365	1225103	0.11876
Paenibacillus sp. lzh-N1	2069255	S	6330	5943	12273	0.00119
Paenibacillus sp. M-152	2487928	S	2441	2058	4499	0.00044
Paenibacillus sp. JZ16	1906272	S	2269	140	2409	0.00023
Paenibacillus sp. IHB B 3084	867076	S	1504	103	1607	0.00016
Paenibacillus sp. S25	2823905	S	1373	966	2339	0.00023
Paenibacillus sp. B01	2660554	S	1221	80	1301	0.00013
Paenibacillus cellulositrophicus	562959	S	12682	567	13249	0.00128
Paenibacillus peoriae	59893	S	6122	1758	7880	0.00076
Paenibacillus brasilensis	128574	S	4913	383	5296	0.00051
Paenibacillus kribbensis	172713	S	3436	231	3667	0.00036
Paenibacillus terrae	159743	S	2009	137	2146	0.00021
Paenibacillus mucilaginosus	61624	S	1411	65	1476	0.00014
Paenibacillus lycopersici	2704462	S	1047	62	1109	0.00011
Brevibacillus choshinensis	54911	S	1339	780	2119	0.00021
Priestia megaterium	1404	S	31395	32665	64060	0.00621
Bacillus tequilensis	227866	S	3601	10716	14317	0.00139
Bacillus sp. S3	486398	S	1469	499	1968	0.00019
Neobacillus drentensis	220684	S	9515	3320	12835	0.00124
Neobacillus mesonae	1193713	S	1135	303	1438	0.00014
Thermaerobacter sp. FW80	2546351	S	1039	537	1576	0.00015
Symbiobacterium thermophilum	2734	S	1231	555	1786	0.00017
Pelosinus sp. UFO1	484770	S	5447	427	5874	0.00057
Limnochorda pilosa	1555112	S	1201	31	1232	0.00012
Deinococcus maricopensis	309887	S	1032	543	1575	0.00015
Deinococcus gobiensis	502394	S	1015	1360	2375	0.00023
Oceanithermus profundus	187137	S	1051	224	1275	0.00012
Truepera radiovictrix	332249	S	1042	79	1121	0.00011
Sphaerobacter thermophilus	2057	S	3439	290	3729	0.00036
Ktedonosporobacter rubrisoli	2509675	S	2441	121	2562	0.00025
Tepidiforma bonchosmolovskayae	2601677	S	1885	73	1958	0.00019
Candidatus Promineofilum breve	1806508	S	1775	31	1806	0.00018
Fimbriimonas ginsengisoli	1005039	S	1123	4	1127	0.00011
Bradyrhizobium sp. 200	2782665	S	19773	4882	24655	0.00239
Bradyrhizobium sp. 170	2782641	S	15820	4467	20287	0.00197
Bradyrhizobium sp. CCBAU 51753	1325100	S	13674	2833	16507	0.00160
Bradyrhizobium sp. CCBAU 051011	858422	S	12143	2231	14374	0.00139
Bradyrhizobium sp. A19	2898149	S	9747	1615	11362	0.00110
Bradyrhizobium sp. BTAi1	288000	S	9638	1704	11342	0.00110
Bradyrhizobium sp. SK17	2057741	S	9283	2988	12271	0.00119
Bradyrhizobium sp. 186	2782654	S	9083	2633	11716	0.00114
Bradyrhizobium sp. ORS 285	115808	S	9021	2025	11046	0.00107
Bradyrhizobium sp. ORS 278	114615	S	8817	1992	10809	0.00105
Bradyrhizobium sp. CCBAU 53421	1325120	S	7787	2423	10210	0.00099
Bradyrhizobium sp. CCBAU 53338	1325111	S	7391	2804	10195	0.00099
Bradyrhizobium sp. CCBAU 53340	1325112	S	6935	2495	9430	0.00091
Bradyrhizobium sp. CCBAU 53351	1325114	S	6856	3254	10110	0.00098
Bradyrhizobium sp. 1(2017)	1404888	S	6737	2064	8801	0.00085
Bradyrhizobium sp. 195	2782662	S	6440	2397	8837	0.00086
Bradyrhizobium sp. 6(2017)	1197460	S	5627	2583	8210	0.00080
Bradyrhizobium sp. S2-11-2	2840472	S	5045	4807	9852	0.00096
Bradyrhizobium sp. CCGE-LA001	1223566	S	4551	1639	6190	0.00060
Bradyrhizobium sp. 41S5	1404443	S	4430	2882	7312	0.00071
Bradyrhizobium sp. S2-20-1	2840469	S	4360	4488	8848	0.00086
Bradyrhizobium sp. S2-11-4	2840473	S	4069	4625	8694	0.00084
Bradyrhizobium sp. I71	2590772	S	3593	3828	7421	0.00072
Bradyrhizobium sp. CCBAU 51765	1325102	S	3578	3879	7457	0.00072
Bradyrhizobium sp. 191	2782659	S	3328	3994	7322	0.00071
Bradyrhizobium sp. C-145	574727	S	2336	2121	4457	0.00043
Bradyrhizobium sp.	376	S	2335	7101	9436	0.00091
Bradyrhizobium sp. 192	2782660	S	1650	3891	5541	0.00054
Bradyrhizobium sp. 144S4	2823807	S	1549	3824	5373	0.00052
Bradyrhizobium sp. 40	2782674	S	1463	4131	5594	0.00054
Bradyrhizobium sp. 323S2	1404649	S	1438	3582	5020	0.00049
Bradyrhizobium sp. 4	2782678	S	1416	4527	5943	0.00058
Bradyrhizobium erythrophlei	1437360	S	41894	2994	44888	0.00435
Bradyrhizobium diazoefficiens	1355477	S	27182	38860	66042	0.00640
Bradyrhizobium canariense	255045	S	12766	17887	30653	0.00297
Bradyrhizobium lablabi	722472	S	12359	12676	25035	0.00243
Bradyrhizobium paxllaeri	190148	S	10783	1769	12552	0.00122
Bradyrhizobium icense	1274631	S	10645	1304	11949	0.00116
Bradyrhizobium genosp. L	83637	S	9919	1767	11686	0.00113
Bradyrhizobium japonicum	375	S	9707	12578	22285	0.00216
Bradyrhizobium arachidis	858423	S	8097	2049	10146	0.00098
Bradyrhizobium oligotrophicum	44255	S	7699	1188	8887	0.00086
Bradyrhizobium guangdongense	1325090	S	6872	2368	9240	0.00090
Bradyrhizobium symbiodeficiens	1404367	S	6708	8929	15637	0.00152
Bradyrhizobium genosp. B	83627	S	6409	1206	7615	0.00074
Bradyrhizobium cosmicum	1404864	S	6128	1760	7888	0.00076
Bradyrhizobium guangzhouense	1325095	S	6074	2044	8118	0.00079
Bradyrhizobium quebecense	2748629	S	5941	2978	8919	0.00086
Bradyrhizobium vignae	1549949	S	5673	1174	6847	0.00066
Bradyrhizobium guangxiense	1325115	S	5136	1976	7112	0.00069
Bradyrhizobium septentrionale	1404411	S	4664	2516	7180	0.00070
Bradyrhizobium amphicarpaeae	1404768	S	4494	1649	6143	0.00060
Bradyrhizobium betae	244734	S	4158	2025	6183	0.00060
Bradyrhizobium daqingense	993502	S	3507	1674	5181	0.00050
Bradyrhizobium elkanii	29448	S	2004	5737	7741	0.00075
Bradyrhizobium zhanjiangense	1325107	S	1917	1700	3617	0.00035
Bradyrhizobium ottawaense	931866	S	1106	6110	7216	0.00070
Rhodopseudomonas palustris	1076	S	21912	7189	29101	0.00282
Rhodopseudomonas sp. SK50-23	340268	S	4304	866	5170	0.00050
Rhodopseudomonas boonkerdii	475937	S	4063	1029	5092	0.00049
Tardiphaga sp. 37S4	1404741	S	3505	7667	11172	0.00108
Tardiphaga robiniae	943830	S	3410	2031	5441	0.00053
Nitrobacter hamburgensis	912	S	8311	1295	9606	0.00093
Nitrobacter winogradskyi	913	S	5473	873	6346	0.00062
Afipia carboxidovorans	40137	S	6348	1233	7581	0.00073
Afipia sp. GAS231	1882747	S	4460	2777	7237	0.00070
Variibacter gotjawalensis	1333996	S	4542	308	4850	0.00047
Mesorhizobium sp. 8	2584466	S	31947	6464	38411	0.00372
Mesorhizobium sp. J8	2777475	S	10236	2758	12994	0.00126
Mesorhizobium sp. B2-8-5	2589903	S	9294	2575	11869	0.00115
Mesorhizobium sp. M2A.F.Ca.ET.043.05.1.1	2493671	S	4958	3512	8470	0.00082
Mesorhizobium sp. DCY119	2108445	S	3689	718	4407	0.00043
Mesorhizobium sp. M1B.F.Ca.ET.045.04.1.1	2493673	S	3519	1129	4648	0.00045
Mesorhizobium sp. M1E.F.Ca.ET.045.02.1.1	2493672	S	3493	1455	4948	0.00048
Mesorhizobium sp. B1-1-8	2589976	S	3465	734	4199	0.00041
Mesorhizobium sp. Pch-S	2082387	S	3371	393	3764	0.00036
Mesorhizobium sp. M1D.F.Ca.ET.043.01.1.1	2493669	S	3232	1615	4847	0.00047
Mesorhizobium sp. M3A.F.Ca.ET.080.04.2.1	2493676	S	3043	782	3825	0.00037
Mesorhizobium sp. M1A.F.Ca.IN.022.06.1.1	2493680	S	2989	808	3797	0.00037
Mesorhizobium sp. B2-1-1	2589974	S	2927	564	3491	0.00034
Mesorhizobium sp. PAMC28654	2880934	S	2888	458	3346	0.00032
Mesorhizobium sp. INR15	2654248	S	2781	341	3122	0.00030
Mesorhizobium sp. 131-2-1	2744518	S	2736	1218	3954	0.00038
Mesorhizobium sp. M4B.F.Ca.ET.058.02.1.1	2493675	S	2556	909	3465	0.00034
Mesorhizobium sp. M2A.F.Ca.ET.046.03.2.1	2493674	S	2282	5038	7320	0.00071
Mesorhizobium sp. M2A.F.Ca.ET.043.02.1.1	2493670	S	2183	4587	6770	0.00066
Mesorhizobium sp. B4-1-4	2589888	S	2029	418	2447	0.00024
Mesorhizobium sp. M9A.F.Ca.ET.002.03.1.2	2493668	S	2004	776	2780	0.00027
Mesorhizobium sp. M7D.F.Ca.US.005.01.1.1	2493678	S	1937	580	2517	0.00024
Mesorhizobium sp. B2-1-8	2589967	S	1878	489	2367	0.00023
Mesorhizobium sp. L-2-11	2744521	S	1876	613	2489	0.00024
Mesorhizobium sp. M8A.F.Ca.ET.057.01.1.1	2493679	S	1868	605	2473	0.00024
Mesorhizobium sp. M6A.T.Cr.TU.016.01.1.1	2493677	S	1861	530	2391	0.00023
Mesorhizobium sp. 113-3-3	2744516	S	1714	816	2530	0.00025
Mesorhizobium sp. 113-3-9	2744517	S	1685	1090	2775	0.00027
Mesorhizobium sp. NZP2298	2483403	S	1680	870	2550	0.00025
Mesorhizobium sp. NZP2077	2483404	S	1665	478	2143	0.00021
Mesorhizobium sp. L-8-3	2744522	S	1644	4412	6056	0.00059
Mesorhizobium sp. 113-1-2	2744515	S	1561	672	2233	0.00022
Mesorhizobium sp. M7A.F.Ce.TU.012.03.2.1	2493681	S	1537	497	2034	0.00020
Mesorhizobium sp. L-8-10	2744523	S	1488	3889	5377	0.00052
Mesorhizobium sp. NBSH29	2654249	S	1166	68	1234	0.00012
Mesorhizobium terrae	2725666	S	3256	894	4150	0.00040
Mesorhizobium opportunistum	593909	S	2819	1037	3856	0.00037
Mesorhizobium amorphae	71433	S	2290	471	2761	0.00027
Mesorhizobium loti	381	S	1971	15729	17700	0.00172
Mesorhizobium erdmanii	1777866	S	1538	391	1929	0.00019
Mesorhizobium huakuii	28104	S	1448	1149	2597	0.00025
Mesorhizobium australicum	536018	S	1446	408	1854	0.00018
Mesorhizobium ciceri	39645	S	1313	3421	4734	0.00046
Mesorhizobium japonicum	2066070	S	1206	813	2019	0.00020
Aminobacter sp. MSH1	374606	S	2808	4517	7325	0.00071
Aquibium microcysteis	675281	S	3991	975	4966	0.00048
Aquibium oceanicum	1670800	S	2866	590	3456	0.00034
Nitratireductor sp. SY7	2599600	S	2503	401	2904	0.00028
Nitratireductor sp. OM-1	1756988	S	1410	247	1657	0.00016
Phyllobacterium sp. T1018	555316	S	1089	174	1263	0.00012
Phyllobacterium zundukense	1867719	S	1023	145	1168	0.00011
Roseitalea porphyridii	1852022	S	1862	276	2138	0.00021
Oricola thermophila	2742145	S	1443	172	1615	0.00016
Rhizobium sp. BG4	2613770	S	3976	941	4917	0.00048
Rhizobium sp. C104	2917727	S	2188	2659	4847	0.00047
Rhizobium sp. WYJ-E13	2849093	S	1869	320	2189	0.00021
Rhizobium sp. NXC24	2048897	S	1530	333	1863	0.00018
Rhizobium sp. ACO-34A	1571470	S	1376	308	1684	0.00016
Rhizobium sp. 11515TR	2028343	S	1229	1417	2646	0.00026
Rhizobium sp. WL3	2603277	S	1148	271	1419	0.00014
Rhizobium sp. AB2/73	2795216	S	1108	1889	2997	0.00029
Rhizobium sp. SL42	2806346	S	1062	215	1277	0.00012
Rhizobium sp. NZLR1	2731096	S	1013	677	1690	0.00016
Rhizobium leguminosarum	384	S	8984	20107	29091	0.00282
Rhizobium etli	29449	S	2038	2238	4276	0.00041
Rhizobium jaguaris	1312183	S	1894	235	2129	0.00021
Rhizobium pseudoryzae	379684	S	1386	292	1678	0.00016
Rhizobium gallicum	56730	S	1290	1472	2762	0.00027
Rhizobium phaseoli	396	S	1288	2393	3681	0.00036
Rhizobium tropici	398	S	1239	307	1546	0.00015
Rhizobium bangladeshense	1138189	S	1054	234	1288	0.00012
Agrobacterium tumefaciens	358	S	3923	7322	11245	0.00109
Agrobacterium vitis	373	S	2271	304	2575	0.00025
Neorhizobium galegae	399	S	5037	1464	6501	0.00063
Neorhizobium sp. NCHU2750	1825976	S	1315	394	1709	0.00017
Neorhizobium sp. SOG26	2060726	S	1049	215	1264	0.00012
Sinorhizobium fredii	380	S	3973	5442	9415	0.00091
Sinorhizobium meliloti	382	S	3030	1051	4081	0.00040
Sinorhizobium sp. BG8	2613773	S	1524	251	1775	0.00017
Sinorhizobium americanum	194963	S	1366	491	1857	0.00018
Sinorhizobium medicae	110321	S	1311	190	1501	0.00015
Ensifer adhaerens	106592	S	3938	3191	7129	0.00069
Ensifer mexicanus	375549	S	2183	333	2516	0.00024
Ensifer sp. PDNC004	2811423	S	1256	604	1860	0.00018
Ensifer alkalisoli	1752398	S	1393	285	1678	0.00016
Ensifer sojae	716925	S	1244	514	1758	0.00017
Shinella sp. HZN7	879274	S	2571	2424	4995	0.00048
Shinella sp. PSBB067	2715959	S	1963	1647	3610	0.00035
Shinella sp. XGS7	2877941	S	1256	1295	2551	0.00025
Shinella zoogloeoides	352475	S	2272	3346	5618	0.00054
Shinella oryzae	2871820	S	1291	595	1886	0.00018
Ciceribacter thiooxidans	1969821	S	1483	302	1785	0.00017
Georhizobium profundi	2341112	S	1387	272	1659	0.00016
Starkeya sp. ORNL1	2709380	S	40746	7266	48012	0.00465
Starkeya novella	921	S	5931	1967	7898	0.00077
Pseudolabrys taiwanensis	331696	S	19620	3041	22661	0.00220
Pseudolabrys sp. FHR47	2562284	S	11942	1992	13934	0.00135
Labrys sp. KNU-23	2789216	S	30686	2845	33531	0.00325
Ancylobacter polymorphus	223390	S	4197	1957	6154	0.00060
Ancylobacter sp. TS-1	1850374	S	4028	1550	5578	0.00054
Ancylobacter pratisalsi	1745854	S	2903	610	3513	0.00034
Xanthobacter dioxanivorans	2528964	S	3644	1160	4804	0.00047
Xanthobacter sp. YC-JY1	2419844	S	1383	1285	2668	0.00026
Xanthobacter autotrophicus	280	S	1291	1303	2594	0.00025
Azorhizobium caulinodans	7	S	2959	566	3525	0.00034
Nordella sp. HKS 07	2712222	S	105421	5180	110601	0.01072
Pseudorhodoplanes sinuspersici	1235591	S	7371	472	7843	0.00076
Terrihabitans soli	708113	S	1782	174	1956	0.00019
Methylobacterium nodulans	114616	S	4547	595	5142	0.00050
Methylobacterium sp. WL1	2603276	S	2093	586	2679	0.00026
Methylobacterium sp. 17Sr1-1	2202826	S	1979	1495	3474	0.00034
Methylobacterium aquaticum	270351	S	4335	3051	7386	0.00072
Methylobacterium durans	2202825	S	3051	462	3513	0.00034
Methylobacterium currus	2051553	S	2797	1797	4594	0.00045
Methylobacterium radiodurans	2202828	S	2573	670	3243	0.00031
Methylobacterium organophilum	410	S	2488	2759	5247	0.00051
Methylobacterium tardum	374432	S	2384	1436	3820	0.00037
Methylobacterium mesophilicum	39956	S	2238	747	2985	0.00029
Methylobacterium terrae	2202827	S	2209	1600	3809	0.00037
Methylobacterium brachiatum	269660	S	2183	1053	3236	0.00031
Methylobacterium indicum	1775910	S	2055	1700	3755	0.00036
Methylobacterium oryzae	334852	S	1825	4537	6362	0.00062
Microvirga sp. 17 mud 1-3	2082949	S	15121	2855	17976	0.00174
Microvirga sp. VF16	2807101	S	10945	1542	12487	0.00121
Microvirga ossetica	1882682	S	11222	1815	13037	0.00126
Microvirga thermotolerans	2651334	S	6945	1752	8697	0.00084
Methylorubrum populi	223967	S	4053	1757	5810	0.00056
Methylorubrum extorquens	408	S	3123	5026	8149	0.00079
Methylorubrum sp. B1-46	2897334	S	1353	539	1892	0.00018
Devosia sp. A16	1736675	S	43067	4884	47951	0.00465
Devosia sp. SL43	2806348	S	3077	594	3671	0.00036
Devosia sp. JXJ CY 41	2917991	S	3066	586	3652	0.00035
Devosia sp. 1566	2499144	S	2205	240	2445	0.00024
Devosia sp. I507	2083786	S	1804	602	2406	0.00023
Devosia ginsengisoli	400770	S	3213	614	3827	0.00037
Devosia beringensis	2657486	S	2886	445	3331	0.00032
Devosia oryziradicis	2801335	S	2784	545	3329	0.00032
Devosia salina	2860336	S	2744	1004	3748	0.00036
Devosia rhizoryzae	2774137	S	2219	236	2455	0.00024
Paradevosia shaoguanensis	1335043	S	6150	2312	8462	0.00082
Youhaiella tibetensis	1447062	S	4631	948	5579	0.00054
Pelagibacterium halotolerans	531813	S	1515	187	1702	0.00017
Rhodoplanes sp. Z2-YC6860	674703	S	39578	3364	42942	0.00416
Hyphomicrobium denitrificans	53399	S	12440	963	13403	0.00130
Hyphomicrobium sp. MC1	717785	S	9125	484	9609	0.00093
Hyphomicrobium nitrativorans	1427356	S	2226	160	2386	0.00023
Methyloceanibacter sp. wino2	2170729	S	1100	209	1309	0.00013
Methyloceanibacter caenitepidi	1384459	S	1068	189	1257	0.00012
Aquabacter sp. L1I39	2820278	S	2389	347	2736	0.00027
Methyloligella sp. GL2	2742204	S	1792	186	1978	0.00019
Rhodomicrobium vannielii	1069	S	1552	90	1642	0.00016
Bosea sp. AS-1	2015316	S	8755	2253	11008	0.00107
Bosea sp. F3-2	2599640	S	7976	2077	10053	0.00097
Bosea sp. ANAM02	2020412	S	6571	1980	8551	0.00083
Bosea sp. Tri-49	1867715	S	4713	906	5619	0.00054
Bosea sp. RAC05	1842539	S	3917	1048	4965	0.00048
Bosea sp. PAMC 26642	1792307	S	2917	514	3431	0.00033
Bosea vaviloviae	1526658	S	3613	731	4344	0.00042
Aureimonas sp. SA4125	2826993	S	2483	423	2906	0.00028
Aureimonas sp. AU20	1349819	S	2187	284	2471	0.00024
Aureimonas sp. OT7	2816454	S	1147	908	2055	0.00020
Aureimonas populi	1701758	S	1730	308	2038	0.00020
Aureimonas mangrovi	2758041	S	1523	294	1817	0.00018
Aureimonas altamirensis	370622	S	1125	347	1472	0.00014
Martelella mediterranea	293089	S	1365	1112	2477	0.00024
Martelella endophytica	1486262	S	1238	386	1624	0.00016
Aurantimonas sp. HBX-1	2906072	S	2625	742	3367	0.00033
Methylocystis parvus	134	S	2004	225	2229	0.00022
Methylocystis bryophila	655015	S	1754	166	1920	0.00019
Methylocystis sp. SC2	187303	S	1120	411	1531	0.00015
Methylocystis heyeri	391905	S	1573	166	1739	0.00017
Methylocystis rosea	173366	S	1153	1350	2503	0.00024
Methylosinus trichosporium	426	S	2364	455	2819	0.00027
Methylosinus sp. C49	2699395	S	1977	367	2344	0.00023
Kaistia sp. 32K	2795690	S	12219	2688	14907	0.00145
Stappia indica	538381	S	2917	668	3585	0.00035
Stappia sp. ES.058	1881061	S	1512	187	1699	0.00016
Pannonibacter phragmitetus	121719	S	2257	1460	3717	0.00036
Roseibium aggregatum	187304	S	1745	285	2030	0.00020
Phreatobacter stygius	1940610	S	4707	635	5342	0.00052
Phreatobacter cathodiphilus	1868589	S	3672	975	4647	0.00045
Phreatobacter sp. NMCR1094	2570229	S	2796	474	3270	0.00032
Methylocella silvestris	199596	S	1824	223	2047	0.00020
Methylocella tundrae	227605	S	1694	179	1873	0.00018
Methylovirgula ligni	569860	S	1716	195	1911	0.00019
Methylovirgula sp. HY1	2822761	S	1421	86	1507	0.00015
Chelatococcus sp. CO-6	1702325	S	3278	1868	5146	0.00050
Chelatococcus daeguensis	444444	S	1843	1059	2902	0.00028
Kaustia mangrovi	2593653	S	3326	294	3620	0.00035
Parvibaculum lavamentivorans	256618	S	1564	1300	2864	0.00028
Pyruvatibacter mobilis	1712261	S	1177	137	1314	0.00013
Blastochloris tepida	2233851	S	3211	981	4192	0.00041
Blastochloris viridis	1079	S	2707	670	3377	0.00033
Acuticoccus sp. I52.16.1	2928472	S	3179	314	3493	0.00034
Hartmannibacter diazotrophicus	1482074	S	2613	417	3030	0.00029
Breoghania sp. L-A4	2304600	S	2201	264	2465	0.00024
Sphingomonas sp. DM2-R-LB4	2899123	S	2735	1069	3804	0.00037
Sphingomonas sp. CL5.1	2653203	S	2318	859	3177	0.00031
Sphingomonas sp. AK-PDB1-5	2872652	S	2264	404	2668	0.00026
Sphingomonas sp. MM-1	745310	S	2009	2995	5004	0.00049
Sphingomonas sp. AP4-R1	2735134	S	1984	269	2253	0.00022
Sphingomonas sp. S8-45	2938948	S	1836	250	2086	0.00020
Sphingomonas sp. Cra20	1327635	S	1824	297	2121	0.00021
Sphingomonas sp. LM7	1938607	S	1706	387	2093	0.00020
Sphingomonas sp. AAP5	1523415	S	1671	465	2136	0.00021
Sphingomonas sp. NBWT7	2596913	S	1464	584	2048	0.00020
Sphingomonas sp. S2-65	2903960	S	1446	307	1753	0.00017
Sphingomonas sp. FARSPH	2219696	S	1418	1251	2669	0.00026
Sphingomonas sp. HDW15A	2714942	S	1362	117	1479	0.00014
Sphingomonas sp. KC8	1030157	S	1207	161	1368	0.00013
Sphingomonas sp. HMP9	1517554	S	1197	508	1705	0.00017
Sphingomonas sp. PAMC26645	2565555	S	1195	383	1578	0.00015
Sphingomonas sp. HMP6	1517551	S	1002	200	1202	0.00012
Sphingomonas sanxanigenens	397260	S	4309	2348	6657	0.00065
Sphingomonas lutea	1045317	S	4064	605	4669	0.00045
Sphingomonas sediminicola	386874	S	3392	388	3780	0.00037
Sphingomonas alpina	653931	S	3285	327	3612	0.00035
Sphingomonas daechungensis	1176646	S	3233	374	3607	0.00035
Sphingomonas sabuli	2764186	S	2768	391	3159	0.00031
Sphingomonas panacisoli	1813879	S	2604	426	3030	0.00029
Sphingomonas ginsengisoli An et al. 2013	363835	S	2602	418	3020	0.00029
Sphingomonas sinipercae	2714944	S	2527	388	2915	0.00028
Sphingomonas profundi	2681549	S	2470	464	2934	0.00028
Sphingomonas panacis	1560345	S	2059	364	2423	0.00023
Sphingomonas piscis	2714943	S	1934	202	2136	0.00021
Sphingomonas hengshuiensis	1609977	S	1881	298	2179	0.00021
Sphingomonas rhizophila	2071607	S	1736	554	2290	0.00022
Sphingomonas taxi	1549858	S	1735	678	2413	0.00023
Sphingomonas koreensis	93064	S	1708	1581	3289	0.00032
Sphingomonas changnyeongensis	2698679	S	1478	320	1798	0.00017
Sphingomonas radiodurans	2890321	S	1271	198	1469	0.00014
Sphingomonas suaedae	2599297	S	1265	199	1464	0.00014
Sphingomonas aliaeris	2759526	S	1235	178	1413	0.00014
Sphingomonas insulae	424800	S	1169	419	1588	0.00015
Sphingomonas xanthus	2594473	S	1137	318	1455	0.00014
Sphingomonas paucimobilis	13689	S	1127	944	2071	0.00020
Sphingopyxis sp. OPL5	2486273	S	7724	1328	9052	0.00088
Sphingopyxis sp. BSN-002	2911495	S	5092	851	5943	0.00058
Sphingopyxis sp. PAMC25046	2565556	S	2948	1324	4272	0.00041
Sphingopyxis sp. YF1	2482763	S	2735	604	3339	0.00032
Sphingopyxis sp. QXT-31	1357916	S	2664	651	3315	0.00032
Sphingopyxis sp. EG6	1874061	S	1794	855	2649	0.00026
Sphingopyxis sp. 113P3	292913	S	1667	667	2334	0.00023
Sphingopyxis sp. FD7	1914525	S	1582	655	2237	0.00022
Sphingopyxis macrogoltabida	33050	S	6100	3246	9346	0.00091
Sphingopyxis lindanitolerans	2054227	S	4924	2711	7635	0.00074
Sphingopyxis terrae	33052	S	2683	1710	4393	0.00043
Sphingopyxis fribergensis	1515612	S	2404	974	3378	0.00033
Sphingopyxis granuli	267128	S	1357	3521	4878	0.00047
Sphingopyxis alaskensis	117207	S	1302	292	1594	0.00015
Sphingobium sp. SYK-6	627192	S	1630	909	2539	0.00025
Sphingobium yanoikuyae	13690	S	1739	6028	7767	0.00075
Novosphingobium sp. Sx8-5	2896849	S	1710	510	2220	0.00022
Novosphingobium sp. EMRT-2	2571749	S	1432	1024	2456	0.00024
Novosphingobium sp. Gsoil 351	2675225	S	1265	121	1386	0.00013
Novosphingobium sp. P6W	1609758	S	1220	282	1502	0.00015
Novosphingobium resinovorum	158500	S	1627	1087	2714	0.00026
Novosphingobium aromaticivorans	48935	S	1156	891	2047	0.00020
Novosphingobium decolorationis	2698673	S	1116	715	1831	0.00018
Rhizorhabdus wittichii	160791	S	3400	2213	5613	0.00054
Rhizorhabdus dicambivorans	1850238	S	1808	1569	3377	0.00033
Rhizorhabdus phycosphaerae	2711156	S	1550	191	1741	0.00017
Sphingosinithalassobacter sp. CS137	2762748	S	1283	289	1572	0.00015
Sphingosinithalassobacter tenebrarum	2711215	S	1140	410	1550	0.00015
Allosphingosinicella indica	941907	S	1651	213	1864	0.00018
Parasphingopyxis algicola	2026624	S	1037	77	1114	0.00011
Hankyongella ginsenosidimutans	1763828	S	1045	221	1266	0.00012
Erythrobacter litoralis	39960	S	1222	838	2060	0.00020
Porphyrobacter sp. CACIAM 03H1	2003315	S	1042	495	1537	0.00015
Qipengyuania flava	192812	S	1472	1602	3074	0.00030
Croceicoccus marinus	450378	S	1186	1048	2234	0.00022
Altererythrobacter sp. B11	2060312	S	1061	790	1851	0.00018
Sphingosinicella sp. BN140058	1892855	S	2187	208	2395	0.00023
Sphingosinicella microcystinivorans	335406	S	1179	167	1346	0.00013
Sandaracinobacter sp. M6	2759707	S	1052	75	1127	0.00011
Azospirillum sp. TSA2s	709810	S	15275	7262	22537	0.00218
Azospirillum sp. TSH100	652764	S	2248	685	2933	0.00028
Azospirillum sp. B510	137722	S	2172	550	2722	0.00026
Azospirillum sp. TSH58	664962	S	1012	832	1844	0.00018
Azospirillum brasilense	192	S	5252	2907	8159	0.00079
Azospirillum oryzae	286727	S	3951	2162	6113	0.00059
Azospirillum thermophilum	2202148	S	3336	645	3981	0.00039
Azospirillum thiophilum	528244	S	2469	588	3057	0.00030
Azospirillum ramasamyi	682998	S	1735	687	2422	0.00023
Azospirillum lipoferum	193	S	1465	704	2169	0.00021
Azospirillum humicireducens	1226968	S	1420	539	1959	0.00019
Skermanella mucosa	1789672	S	1668	1115	2783	0.00027
Skermanella sp. TT6	2775420	S	1552	1557	3109	0.00030
Skermanella rosea	1817965	S	1422	1260	2682	0.00026
Skermanella pratensis	2233999	S	1282	676	1958	0.00019
Nitrospirillum amazonense	28077	S	2614	262	2876	0.00028
Indioceanicola profundi	2220096	S	1652	189	1841	0.00018
Roseomonas sp. S08	1750527	S	7424	643	8067	0.00078
Roseomonas sp. OT10	2897332	S	4162	1290	5452	0.00053
Roseomonas gilardii	257708	S	3323	3904	7227	0.00070
Roseomonas haemaphysalidis	2768162	S	2889	452	3341	0.00032
Roseomonas marmotae	2768161	S	2685	450	3135	0.00030
Rhodovastum atsumiense	504468	S	5135	725	5860	0.00057
Roseococcus microcysteis	2771361	S	2853	487	3340	0.00032
Sediminicoccus rosea	1225128	S	2382	231	2613	0.00025
Acidibrevibacterium fodinaquatile	1969806	S	2006	246	2252	0.00022
Lichenicola cladoniae	1484109	S	1991	150	2141	0.00021
Gluconacetobacter diazotrophicus	33996	S	1289	865	2154	0.00021
Granulibacter bethesdensis	364410	S	1043	152	1195	0.00012
Hypericibacter terrae	2602015	S	6049	737	6786	0.00066
Hypericibacter adhaerens	2602016	S	5288	840	6128	0.00059
Magnetospirillum sp. XM-1	1663591	S	1063	539	1602	0.00016
Magnetospirillum gryphiswaldense	55518	S	1315	105595	106910	0.01036
Magnetospirillum magneticum	84159	S	1153	119	1272	0.00012
Rhodospirillum centenum	34018	S	2168	291	2459	0.00024
Rhodospirillum rubrum	1085	S	1224	88	1312	0.00013
Tistrella mobilis	171437	S	2657	1467	4124	0.00040
Ferrovibrio terrae	2594003	S	2095	136	2231	0.00022
Defluviicoccus vanus	111831	S	1192	104	1296	0.00013
Stella humosa	94	S	4728	333	5061	0.00049
Elioraea tepida	2843330	S	2183	101	2284	0.00022
Paracoccus sanguinis	1545044	S	1270	512	1782	0.00017
Paracoccus yeei	147645	S	1087	2871	3958	0.00038
Paracoccus denitrificans	266	S	1051	855	1906	0.00018
Rhodobacter sp. CZR27	2033869	S	1134	596	1730	0.00017
Rhodobacter sp. N10	2807096	S	1045	202	1247	0.00012
Rhodobacter capsulatus	1061	S	1325	417	1742	0.00017
Cereibacter sphaeroides	1063	S	3003	2486	5489	0.00053
Polymorphum gilvum	991904	S	2112	582	2694	0.00026
Paroceanicella profunda	2579971	S	1969	964	2933	0.00028
Pikeienuella piscinae	2748098	S	1305	156	1461	0.00014
Pelagovum pacificum	2588711	S	1177	233	1410	0.00014
Pontivivens ytuae	2789856	S	1167	127	1294	0.00013
Roseovarius indicus	540747	S	1137	1059	2196	0.00021
Salipiger profundus	1229727	S	1343	1173	2516	0.00024
Salipiger abyssi	1250539	S	1086	811	1897	0.00018
Roseivivax marinus	1379903	S	1192	383	1575	0.00015
Celeribacter indicus	1208324	S	1166	1166	2332	0.00023
Yangia pacifica	311180	S	1143	349	1492	0.00014
Sagittula sp. P11	2009329	S	1027	885	1912	0.00019
Caulobacter sp. S6	2823693	S	4122	451	4573	0.00044
Caulobacter sp. FWC26	69665	S	1453	588	2041	0.00020
Caulobacter segnis	88688	S	5440	1780	7220	0.00070
Caulobacter mirabilis	69666	S	3575	661	4236	0.00041
Caulobacter soli	2708539	S	3001	879	3880	0.00038
Caulobacter flavus	1679497	S	2956	776	3732	0.00036
Caulobacter vibrioides	155892	S	2935	1693	4628	0.00045
Caulobacter rhizosphaerae	2010972	S	2905	777	3682	0.00036
Caulobacter henricii	69395	S	1257	202	1459	0.00014
Brevundimonas sp. PAMC22021	2861285	S	1044	1153	2197	0.00021
Brevundimonas sp. LM2	1938605	S	1022	731	1753	0.00017
Brevundimonas naejangsanensis	588932	S	1772	1989	3761	0.00036
Brevundimonas albigilva	1312364	S	1232	1652	2884	0.00028
Brevundimonas goettingensis	2774190	S	1203	429	1632	0.00016
Phenylobacterium zucineum	284016	S	7808	1632	9440	0.00092
Phenylobacterium parvum	2201350	S	2170	247	2417	0.00023
Terricaulis silvestris	2686094	S	1211	42	1253	0.00012
Marinicauda algicola	2029849	S	1351	229	1580	0.00015
Burkholderia cenocepacia	95486	S	22037	49237	71274	0.00691
Burkholderia multivorans	87883	S	3706	1665	5371	0.00052
Burkholderia ubonensis	101571	S	3534	1857	5391	0.00052
Burkholderia cepacia	292	S	2835	3725	6560	0.00064
Burkholderia anthina	179879	S	1949	1551	3500	0.00034
Burkholderia pyrrocinia	60550	S	1684	716	2400	0.00023
Burkholderia contaminans	488447	S	1542	843	2385	0.00023
Burkholderia ambifaria	152480	S	1389	954	2343	0.00023
Burkholderia stabilis	95485	S	1214	790	2004	0.00019
Burkholderia stagnalis	1503054	S	1190	365	1555	0.00015
Burkholderia lata	482957	S	1151	883	2034	0.00020
Burkholderia dolosa	152500	S	1013	387	1400	0.00014
Burkholderia pseudomallei	28450	S	3309	19943	23252	0.00225
Burkholderia thailandensis	57975	S	1227	3831	5058	0.00049
Burkholderia mayonis	1385591	S	1137	232	1369	0.00013
Burkholderia sp. DHOD12	2571746	S	1746	1301	3047	0.00030
Burkholderia gladioli	28095	S	4182	1348	5530	0.00054
Burkholderia glumae	337	S	1533	587	2120	0.00021
Burkholderia plantarii	41899	S	1193	383	1576	0.00015
Paraburkholderia graminis	60548	S	8121	2393	10514	0.00102
Paraburkholderia sp. SOS3	1926494	S	1426	294	1720	0.00017
Paraburkholderia phenoliruptrix	252970	S	2197	775	2972	0.00029
Paraburkholderia aromaticivorans	2026199	S	2091	1144	3235	0.00031
Paraburkholderia pallida	2547399	S	1908	391	2299	0.00022
Paraburkholderia caribensis	75105	S	1753	1650	3403	0.00033
Paraburkholderia acidisoli	2571748	S	1596	323	1919	0.00019
Paraburkholderia caledonica	134536	S	1581	340	1921	0.00019
Paraburkholderia tropica	92647	S	1575	396	1971	0.00019
Paraburkholderia phytofirmans	261302	S	1510	758	2268	0.00022
Paraburkholderia edwinii	2861782	S	1483	235	1718	0.00017
Paraburkholderia acidiphila	2571747	S	1395	305	1700	0.00016
Paraburkholderia terricola	169427	S	1304	449	1753	0.00017
Paraburkholderia atlantica	2654982	S	1290	369	1659	0.00016
Paraburkholderia phymatum	148447	S	1253	392	1645	0.00016
Paraburkholderia sprentiae	948107	S	1232	316	1548	0.00015
Paraburkholderia fungorum	134537	S	1120	320	1440	0.00014
Paraburkholderia megapolitana	420953	S	1057	110	1167	0.00011
Paraburkholderia ginsengisoli	311231	S	1026	373	1399	0.00014
Cupriavidus taiwanensis	164546	S	5966	7723	13689	0.00133
Cupriavidus pauculus	82633	S	4710	2410	7120	0.00069
Cupriavidus basilensis	68895	S	2769	1762	4531	0.00044
Cupriavidus necator	106590	S	2564	3827	6391	0.00062
Cupriavidus sp. EM10	2839983	S	1215	1073	2288	0.00022
Cupriavidus oxalaticus	96344	S	2504	1454	3958	0.00038
Cupriavidus campinensis	151783	S	2103	943	3046	0.00030
Cupriavidus metallidurans	119219	S	1707	1348	3055	0.00030
Cupriavidus pinatubonensis	248026	S	1521	304	1825	0.00018
Ralstonia solanacearum	305	S	3810	8159	11969	0.00116
Ralstonia insidiosa	190721	S	1138	947	2085	0.00020
Ralstonia sp. 56D2	2842456	S	1059	172	1231	0.00012
Pandoraea sp. XY-2	2518599	S	1397	1063	2460	0.00024
Pandoraea pnomenusa	93220	S	1276	965	2241	0.00022
Pandoraea thiooxydans	445709	S	1091	103	1194	0.00012
Pandoraea pulmonicola	93221	S	1034	436	1470	0.00014
Caballeronia sp. Lep1P3	2878150	S	1092	2126	3218	0.00031
Caballeronia zhejiangensis	871203	S	1719	430	2149	0.00021
Caballeronia insecticola	758793	S	1404	314	1718	0.00017
Caballeronia grimmiae	1071679	S	1378	766	2144	0.00021
Variovorax sp. HW608	1034889	S	4613	911	5524	0.00054
Variovorax sp. PBS-H4	434008	S	2662	1768	4430	0.00043
Variovorax sp. RKNM96	2681552	S	2366	981	3347	0.00032
Variovorax sp. PBL-H6	434009	S	2225	2440	4665	0.00045
Variovorax sp. PAMC26660	2762322	S	2222	630	2852	0.00028
Variovorax sp. RA8	662548	S	2176	1864	4040	0.00039
Variovorax sp. PAMC 28711	1795631	S	2040	402	2442	0.00024
Variovorax sp. WDL1	207745	S	2020	3858	5878	0.00057
Variovorax sp. PAMC28562	2762323	S	1623	161	1784	0.00017
Variovorax sp. 38R	2774875	S	1225	1477	2702	0.00026
Variovorax sp. SRS16	282217	S	1220	3453	4673	0.00045
Variovorax sp. PBL-E5	434014	S	1081	3548	4629	0.00045
Variovorax paradoxus	34073	S	11281	11148	22429	0.00217
Variovorax boronicumulans	436515	S	1625	1222	2847	0.00028
Hydrogenophaga sp. BA0156	2716225	S	2248	1909	4157	0.00040
Hydrogenophaga sp. BPS33	2651974	S	2004	1548	3552	0.00034
Hydrogenophaga sp. YM1	2806262	S	1988	1267	3255	0.00032
Hydrogenophaga sp. PBC	795665	S	1856	2454	4310	0.00042
Hydrogenophaga sp. SL48	2806347	S	1553	833	2386	0.00023
Hydrogenophaga sp. RAC07	1842537	S	1164	513	1677	0.00016
Hydrogenophaga sp. PBL-H3	434010	S	1153	1232	2385	0.00023
Hydrogenophaga taeniospiralis	65656	S	1270	1062	2332	0.00023
Acidovorax sp. YS12	2738413	S	1429	1885	3314	0.00032
Acidovorax avenae	80867	S	3027	3081	6108	0.00059
Acidovorax monticola	1926868	S	1740	879	2619	0.00025
Acidovorax antarcticus	2743470	S	1437	1412	2849	0.00028
Acidovorax carolinensis	553814	S	1004	1073	2077	0.00020
Ramlibacter tataouinensis	94132	S	14761	6953	21714	0.00210
Comamonas aquatica	225991	S	1243	2598	3841	0.00037
Comamonas serinivorans	1082851	S	1202	507	1709	0.00017
Rhodoferax sp. BAB1	2741720	S	1632	578	2210	0.00021
Rhodoferax koreense	1842727	S	2785	1821	4606	0.00045
Rhodoferax sediminis	2509614	S	1980	382	2362	0.00023
Polaromonas sp. JS666	296591	S	1903	3035	4938	0.00048
Polaromonas naphthalenivorans	216465	S	1280	225	1505	0.00015
Diaphorobacter ruginosibacter	1715720	S	1084	1217	2301	0.00022
Delftia tsuruhatensis	180282	S	1166	5322	6488	0.00063
Schlegelella thermodepolymerans	215580	S	2625	1451	4076	0.00040
Schlegelella brevitalea	413882	S	2459	404	2863	0.00028
Kinneretia sp. DAIF2	2714952	S	2482	1053	3535	0.00034
Kinneretia sp. XES5	2877940	S	1154	1942	3096	0.00030
Ottowia sp. 27C	2816950	S	1211	284	1495	0.00014
Ottowia oryzae	2109914	S	1081	281	1362	0.00013
Alicycliphilus denitrificans	179636	S	2621	5277	7898	0.00077
Melaminivora sp. SC2-9	2109913	S	1163	1595	2758	0.00027
Verminephrobacter eiseniae	364317	S	1338	199	1537	0.00015
Hylemonella gracilis	80880	S	1218	209	1427	0.00014
Pulveribacter suum	2116657	S	1061	681	1742	0.00017
Massilia sp. WG5	1707785	S	4284	2945	7229	0.00070
Massilia sp. LPB0304	2769491	S	2135	1490	3625	0.00035
Massilia sp. HC52	2852099	S	1994	1117	3111	0.00030
Massilia sp. NP310	2861282	S	1586	1482	3068	0.00030
Massilia sp. DM-R-R2A-13	2899220	S	1529	666	2195	0.00021
Massilia sp. YMA4	1593482	S	1483	1086	2569	0.00025
Massilia sp. PAMC28688	2861283	S	1233	338	1571	0.00015
Massilia putida	1141883	S	3960	1322	5282	0.00051
Massilia violaceinigra	2045208	S	2768	815	3583	0.00035
Massilia flava	871742	S	2213	574	2787	0.00027
Massilia umbonata	864828	S	1583	658	2241	0.00022
Massilia lutea	321985	S	1556	495	2051	0.00020
Massilia albidiflava	321983	S	1515	624	2139	0.00021
Massilia plicata	321984	S	1425	400	1825	0.00018
Massilia armeniaca	2072590	S	1369	737	2106	0.00020
Massilia oculi	945844	S	1306	843	2149	0.00021
Massilia antarctica	2765360	S	1249	474	1723	0.00017
Duganella sp. GN2-R2	2728020	S	2403	1057	3460	0.00034
Duganella sp. AF9R3	2728021	S	1362	315	1677	0.00016
Herbaspirillum robiniae	2014887	S	1677	745	2422	0.00023
Herbaspirillum hiltneri	341045	S	1312	272	1584	0.00015
Herbaspirillum seropedicae	964	S	1169	533	1702	0.00017
Herbaspirillum frisingense	92645	S	1051	414	1465	0.00014
Herbaspirillum rubrisubalbicans	80842	S	1040	603	1643	0.00016
Janthinobacterium sp. 17J80-10	2497863	S	1561	514	2075	0.00020
Janthinobacterium agaricidamnosum	55508	S	1282	2934	4216	0.00041
Collimonas fungivorans	158899	S	1537	468	2005	0.00019
Collimonas arenae	279058	S	1222	171	1393	0.00014
Collimonas pratensis	279113	S	1035	229	1264	0.00012
Noviherbaspirillum sp. UKPF54	2601898	S	3020	596	3616	0.00035
Achromobacter xylosoxidans	85698	S	5252	8613	13865	0.00134
Achromobacter sp. AONIH1	1758194	S	1291	2209	3500	0.00034
Achromobacter sp. 77	2756133	S	1238	2624	3862	0.00037
Achromobacter sp. MFA1 R4	1881016	S	1068	503	1571	0.00015
Achromobacter spanius	217203	S	2333	1068	3401	0.00033
Achromobacter mucicolens	1389922	S	2226	2543	4769	0.00046
Achromobacter denitrificans	32002	S	1877	1331	3208	0.00031
Achromobacter deleyi	1353891	S	1561	1051	2612	0.00025
Achromobacter insolitus	217204	S	1057	285	1342	0.00013
Bordetella sp. H567	1697043	S	1740	535	2275	0.00022
Bordetella sp. N	1746199	S	1383	233	1616	0.00016
Bordetella bronchialis	463025	S	1797	716	2513	0.00024
Bordetella genomosp. 8	1416806	S	1694	649	2343	0.00023
Bordetella genomosp. 13	463040	S	1429	1474	2903	0.00028
Bordetella flabilis	463014	S	1303	230	1533	0.00015
Bordetella genomosp. 9	1416803	S	1268	586	1854	0.00018
Bordetella hinzii	103855	S	1120	1992	3112	0.00030
Bordetella petrii	94624	S	1035	1861	2896	0.00028
Pigmentiphaga sp. H8	2488560	S	2177	316	2493	0.00024
Orrella dioscoreae	1851544	S	1132	491	1623	0.00016
Castellaniella defragrans	75697	S	1236	1088	2324	0.00023
Paralcaligenes sp. KSB-10	2901142	S	1191	54	1245	0.00012
Rhizobacter gummiphilus	946333	S	3801	847	4648	0.00045
Rhizobacter sp. AJA081-3	2753607	S	3271	947	4218	0.00041
Methylibium petroleiphilum	105560	S	2078	2001	4079	0.00040
Methylibium sp. Pch-M	2082386	S	1629	1271	2900	0.00028
Sphaerotilus sp. FB-5	2914710	S	2246	1767	4013	0.00039
Sphaerotilus natans	34103	S	2028	893	2921	0.00028
Rubrivivax gelatinosus	28068	S	3062	1085	4147	0.00040
Aquincola tertiaricarbonis	391953	S	3002	1232	4234	0.00041
Mitsuaria sp. 7	1658665	S	2517	570	3087	0.00030
Leptothrix cholodnii	34029	S	2399	865	3264	0.00032
Xylophilus rhododendri	2697032	S	2072	689	2761	0.00027
Ideonella dechloratans	36863	S	1545	1089	2634	0.00026
Roseateles depolymerans	76731	S	1251	277	1528	0.00015
Aquabacterium olei	1296669	S	1176	356	1532	0.00015
Tepidimonas taiwanensis	307486	S	1101	481	1582	0.00015
Thauera sp. MZ1T	85643	S	1597	2120	3717	0.00036
Thauera sp. K11	2005884	S	1573	1052	2625	0.00025
Thauera humireducens	1134435	S	1021	745	1766	0.00017
Azoarcus sp. KH32C	748247	S	1712	337	2049	0.00020
Azoarcus sp. DD4	2027405	S	1323	983	2306	0.00022
Azoarcus olearius	418699	S	1460	582	2042	0.00020
Azoarcus communis	41977	S	1177	550	1727	0.00017
Nitrogeniibacter mangrovi	2016596	S	1251	295	1546	0.00015
Aromatoleum petrolei	76116	S	1493	399	1892	0.00018
Aromatoleum aromaticum	551760	S	1212	1070	2282	0.00022
Aromatoleum pumilum	2067960	S	1003	421	1424	0.00014
Azospira restricta	404405	S	2205	1939	4144	0.00040
Niveibacterium microcysteis	2811415	S	1017	162	1179	0.00011
Dechloromonas denitrificans	281362	S	1208	398	1606	0.00016
Ferribacterium limneticum	76259	S	1489	312	1801	0.00017
Usitatibacter rugosus	2732067	S	4808	653	5461	0.00053
Usitatibacter palustris	2732487	S	3891	556	4447	0.00043
Nitrosospira lacus	1288494	S	1949	698	2647	0.00026
Nitrosospira multiformis	1231	S	1286	386	1672	0.00016
Sulfuritalea hydrogenivorans	748811	S	1049	235	1284	0.00012
Thiobacillus denitrificans	36861	S	1317	349	1666	0.00016
Jeongeupia sp. USM3	1906741	S	1189	882	2071	0.00020
Crenobacter cavernae	2290923	S	1113	917	2030	0.00020
Lysobacter sp. TY2-98	2290922	S	2041	444	2485	0.00024
Lysobacter sp. KIS68-7	2904252	S	1844	499	2343	0.00023
Lysobacter sp. 5GHs7-4	2904253	S	1556	681	2237	0.00022
Lysobacter sp. K5869	2820808	S	1253	896	2149	0.00021
Lysobacter sp. CECT 30171	2822368	S	1193	411	1604	0.00016
Lysobacter sp. S4-A87	2925843	S	1171	569	1740	0.00017
Lysobacter enzymogenes	69	S	5029	2647	7676	0.00074
Lysobacter capsici	435897	S	3505	5642	9147	0.00089
Lysobacter soli	453783	S	2235	649	2884	0.00028
Lysobacter lycopersici	1324796	S	1936	554	2490	0.00024
Lysobacter antibioticus	84531	S	1913	578	2491	0.00024
Lysobacter solisilvae (ex Woo and Kim 2022)	2865112	S	1699	698	2397	0.00023
Lysobacter solisilvae (ex Kim et al. 2021)	2763317	S	1565	427	1992	0.00019
Lysobacter maris	1605891	S	1453	486	1939	0.00019
Lysobacter arenosi	2795387	S	1215	569	1784	0.00017
Lysobacter alkalisoli	2591633	S	1166	294	1460	0.00014
Lysobacter oculi	2698682	S	1030	390	1420	0.00014
Stenotrophomonas maltophilia	40324	S	6010	12868	18878	0.00183
Stenotrophomonas rhizophila	216778	S	2120	892	3012	0.00029
Stenotrophomonas acidaminiphila	128780	S	1321	4345	5666	0.00055
Xanthomonas translucens	343	S	2112	5296	7408	0.00072
Xanthomonas campestris	339	S	1710	3875	5585	0.00054
Xanthomonas sacchari	56458	S	1216	664	1880	0.00018
Xanthomonas arboricola	56448	S	1035	3607	4642	0.00045
Luteimonas sp. S4-F44	2925842	S	1237	346	1583	0.00015
Luteimonas sp. MC1750	2799326	S	1222	659	1881	0.00018
Luteimonas sp. D4P002	2901869	S	1214	498	1712	0.00017
Luteimonas sp. MC1572	2799325	S	1021	748	1769	0.00017
Luteimonas granuli	1176533	S	1260	739	1999	0.00019
Luteimonas chenhongjianii	2006110	S	1052	353	1405	0.00014
Pseudoxanthomonas mexicana	128785	S	3329	4726	8055	0.00078
Pseudoxanthomonas suwonensis	314722	S	2508	1708	4216	0.00041
Pseudoxanthomonas sp. X-1	2571115	S	1485	1803	3288	0.00032
Pseudoxanthomonas daejeonensis	266062	S	1157	398	1555	0.00015
Thermomonas brevis	215691	S	1418	807	2225	0.00022
Thermomonas aquatica	2202149	S	1149	782	1931	0.00019
Pseudolysobacter antarcticus	2511995	S	1764	73	1837	0.00018
Arenimonas daejeonensis	370777	S	1494	425	1919	0.00019
Dyella japonica	231455	S	6026	2017	8043	0.00078
Dyella telluris	2763498	S	5852	1764	7616	0.00074
Dyella terrae	522259	S	3644	602	4246	0.00041
Dyella thiooxydans	445710	S	3635	1232	4867	0.00047
Dyella caseinilytica	1849581	S	1316	124	1440	0.00014
Frateuria sp. 5GH9-34	2898793	S	8799	2898	11697	0.00113
Frateuria sp. 5GH9-11	1542730	S	6708	2799	9507	0.00092
Rhodanobacter denitrificans	666685	S	5443	2269	7712	0.00075
Rhodanobacter thiooxydans	416169	S	3271	1601	4872	0.00047
Rhodanobacter sp. FDAARGOS 1247	2778082	S	3206	1145	4351	0.00042
Rhodanobacter glycinis	582702	S	2130	443	2573	0.00025
Luteibacter sp. 321	2911537	S	2423	912	3335	0.00032
Luteibacter sp. EIF3	2780091	S	2185	399	2584	0.00025
Luteibacter sp. 335	2911538	S	1491	375	1866	0.00018
Luteibacter sp. 353	2911539	S	1444	536	1980	0.00019
Luteibacter rhizovicinus	242606	S	1925	317	2242	0.00022
Luteibacter pinisoli	2589080	S	1690	506	2196	0.00021
Luteibacter anthropi	564369	S	1443	303	1746	0.00017
Dokdonella koreensis	323415	S	6881	1500	8381	0.00081
Aerosticca soli	2010829	S	2157	3653	5810	0.00056
Pseudomonas sp. SCB32	2653853	S	1998	3449	5447	0.00053
Pseudomonas sp. ATCC 13867	1294143	S	1135	2618	3753	0.00036
Pseudomonas fluorescens	294	S	3829	5827	9656	0.00094
Pseudomonas aeruginosa	287	S	3631	55187	58818	0.00570
Pseudomonas mendocina	300	S	1514	925	2439	0.00024
Pseudomonas alcaligenes	43263	S	1035	1074	2109	0.00020
Pseudomonas putida	303	S	4869	9887	14756	0.00143
Pseudomonas oryzihabitans	47885	S	1299	510	1809	0.00018
Pseudomonas stutzeri	316	S	4874	5203	10077	0.00098
Pseudomonas syringae	317	S	1167	3275	4442	0.00043
Pseudomonas chlororaphis	587753	S	2210	3835	6045	0.00059
Pseudomonas umsongensis	198618	S	1555	433	1988	0.00019
Pseudomonas psychrotolerans	237610	S	1294	526	1820	0.00018
Pseudomonas knackmussii	65741	S	1286	1760	3046	0.00030
Pseudomonas otitidis	319939	S	1219	482	1701	0.00016
Pseudomonas oryzae	1392877	S	1028	583	1611	0.00016
Azotobacter chroococcum	353	S	1040	1102	2142	0.00021
Serratia marcescens	615	S	1116	8694	9810	0.00095
Spiribacter sp. E85	2182432	S	1436	388	1824	0.00018
Candidatus Thiodictyon syntrophicum	1166950	S	1533	189	1722	0.00017
Marichromatium purpuratum	37487	S	1239	528	1767	0.00017
Thioflavicoccus mobilis	80679	S	1200	226	1426	0.00014
Thiocapsa bogorovii	521689	S	1012	127	1139	0.00011
Solimonas sp. K1W22B-7	2303331	S	2282	361	2643	0.00026
Steroidobacter denitrificans	465721	S	1885	1342	3227	0.00031
Sulfurifustis variabilis	1675686	S	2131	202	2333	0.00023
Immundisolibacter cernigliae	1810504	S	1286	372	1658	0.00016
Sorangium cellulosum	56	S	79812	9383	89195	0.00865
Polyangium aurulentum	2567896	S	23924	2264	26188	0.00254
Chondromyces crocatus	52	S	9924	446	10370	0.00101
Sandaracinus amylolyticus	927083	S	23021	1229	24250	0.00235
Labilithrix luteola	1391654	S	21182	893	22075	0.00214
Myxococcus xanthus	34	S	6687	18485	25172	0.00244
Myxococcus hansupus	1297742	S	3398	389	3787	0.00037
Myxococcus stipitatus	83455	S	2903	497	3400	0.00033
Myxococcus sp. SCHIC003	2813577	S	2498	422	2920	0.00028
Corallococcus coralloides	184914	S	6483	2702	9185	0.00089
Corallococcus sp. EGB	1521117	S	4089	1565	5654	0.00055
Corallococcus macrosporus	35	S	3929	930	4859	0.00047
Pyxidicoccus sp. SCPEA002	2813578	S	8973	535	9508	0.00092
Archangium violaceum	83451	S	14370	3141	17511	0.00170
Archangium gephyra	48	S	7441	1949	9390	0.00091
Stigmatella aurantiaca	41	S	11075	1116	12191	0.00118
Cystobacter fuscus	43	S	6010	1687	7697	0.00075
Melittangium boletus	83453	S	4391	1126	5517	0.00053
Anaeromyxobacter sp. Red232	2918170	S	6437	699	7136	0.00069
Anaeromyxobacter sp. Red630	2918171	S	5085	698	5783	0.00056
Anaeromyxobacter sp. Fw109-5	404589	S	4644	606	5250	0.00051
Anaeromyxobacter sp. K	447217	S	1236	2366	3602	0.00035
Anaeromyxobacter dehalogenans	161493	S	4056	2850	6906	0.00067
Vulgatibacter incomptus	1391653	S	3856	321	4177	0.00041
Haliangium ochraceum	80816	S	7122	511	7633	0.00074
Geomonas sp. RF6	2897342	S	1069	1647	2716	0.00026
Desulfuromonas versatilis	2802975	S	1304	525	1829	0.00018
Persicimonas caeni	2292766	S	2637	120	2757	0.00027
Paludisphaera borealis	1387353	S	37729	4427	42156	0.00409
Aquisphaera giovannonii	406548	S	18111	1795	19906	0.00193
Tautonia plasticadhaerens	2527974	S	14290	750	15040	0.00146
Singulisphaera acidiphila	466153	S	13200	1034	14234	0.00138
Isosphaera pallida	128	S	1351	55	1406	0.00014
Gemmata obscuriglobus	114	S	6246	712	6958	0.00067
Gemmata massiliana	1210884	S	3025	1183	4208	0.00041
Gemmata sp. SH-PL17	1630693	S	2809	1237	4046	0.00039
Urbifossiella limnaea	2528023	S	12236	882	13118	0.00127
Frigoriglobus tundricola	2774151	S	7516	1107	8623	0.00084
Limnoglobus roseus	2598579	S	5389	211	5600	0.00054
Lacipirellula parvula	2650471	S	15528	968	16496	0.00160
Lacipirellula limnantheis	2528024	S	3670	265	3935	0.00038
Pirellulimonas nuda	2528009	S	2566	188	2754	0.00027
Botrimarina mediterranea	2528022	S	2077	127	2204	0.00021
Lignipirellula cremea	2528010	S	1898	249	2147	0.00021
Anatilimnocola aggregata	2528021	S	1741	224	1965	0.00019
Bremerella volcania	2527984	S	1279	80	1359	0.00013
Planctomyces sp. SH-PL62	1636152	S	21383	3725	25108	0.00243
Planctomyces sp. SH-PL14	1632864	S	4057	243	4300	0.00042
Caulifigura coniformis	2527983	S	2558	167	2725	0.00026
Maioricimonas rarisocia	2528026	S	1998	278	2276	0.00022
Alienimonas californiensis	2527989	S	1916	136	2052	0.00020
Humisphaera borealis	2807512	S	4723	99	4822	0.00047
Phycisphaera mikurensis	547188	S	1809	145	1954	0.00019
Opitutus sp. GAS368	1882749	S	5583	693	6276	0.00061
Opitutus terrae	107709	S	2803	113	2916	0.00028
Lacunisphaera limnophila	1838286	S	5374	670	6044	0.00059
Nibricoccus aquaticus	2576891	S	2190	89	2279	0.00022
Oleiharenicola sp. KSB-15	2862869	S	1568	73	1641	0.00016
Verrucomicrobium sp. GAS474	1882831	S	1390	175	1565	0.00015
Verrucomicrobium spinosum	2736	S	1253	119	1372	0.00013
Luteolibacter ambystomatis	2824561	S	1202	138	1340	0.00013
Roseimicrobium sp. ORNL1	2711231	S	1629	86	1715	0.00017
Chryseolinea soli	2321403	S	1830	1116	2946	0.00029
Niastella koreensis	354356	S	6867	1823	8690	0.00084
Chitinophaga sp. KRA15-503	2829818	S	1137	1203	2340	0.00023
Chitinophaga oryzae	2725414	S	1511	807	2318	0.00022
Paraflavitalea soli	2315862	S	1406	328	1734	0.00017
Pseudobacter ginsenosidimutans	661488	S	1154	338	1492	0.00014
Mucilaginibacter ginsenosidivorans	398053	S	1255	1738	2993	0.00029
Rhodothermus marinus	29549	S	1851	261	2112	0.00020
Rhodocaloribacter litoris	2558931	S	1676	423	2099	0.00020
Salinibacter ruber	146919	S	1206	62	1268	0.00012
Gemmatirosa kalamazoonesis	861299	S	26067	2164	28231	0.00274
Gemmatimonas groenlandica	2732249	S	4211	474	4685	0.00045
Gemmatimonas aurantiaca	173480	S	2863	287	3150	0.00031
Gemmatimonas phototrophica	1379270	S	2410	331	2741	0.00027
Granulicella sp. WH15	2602070	S	1943	335	2278	0.00022
Granulicella sp. 5B5	1617967	S	1593	247	1840	0.00018
Granulicella mallensis	940614	S	1637	190	1827	0.00018
Granulicella tundricola	940615	S	1229	158	1387	0.00013
Candidatus Koribacter versatilis	658062	S	5174	168	5342	0.00052
Terriglobus roseus	392734	S	2285	458	2743	0.00027
Terriglobus albidus	1592106	S	1646	150	1796	0.00017
Terriglobus saanensis	870903	S	1022	131	1153	0.00011
Edaphobacter sp. 12200R-103	2703788	S	3901	560	4461	0.00043
Edaphobacter sp. 4G125	2763071	S	1031	125	1156	0.00011
Acidobacterium capsulatum	33075	S	2282	276	2558	0.00025
Acidobacterium sp. 4Y35	2763107	S	2112	149	2261	0.00022
Acidisarcina polymorpha	2211140	S	1458	102	1560	0.00015
Paludibaculum fermentans	1473598	S	4904	117	5021	0.00049
Luteitalea sp. TBR-22	2802971	S	6475	925	7400	0.00072
Luteitalea pratensis	1855912	S	5360	465	5825	0.00056
Sulfidibacter corallicola	2818388	S	1085	28	1113	0.00011
Nitrospira moscoviensis	42253	S	2005	239	2244	0.00022
Fusarium acuminatum	5515	S	32216	3739	35955	0.00349
Cordyceps fumosorosea	114497	S	1009	123	1132	0.00011
Colletotrichum higginsianum	80884	S	1110	887	1997	0.00019
Thermothielavioides terrestris	2587410	S	1460	220	1680	0.00016
Thermothelomyces thermophilus	78579	S	1251	137	1388	0.00013
Candida dubliniensis	42374	S	9191	598	9789	0.00095
Pseudozyma flocculosa	84751	S	1350	93	1443	0.00014
Phytophthora cinnamomi	4785	S	1050	884	1934	0.00019
