name	taxonomy_id	taxonomy_lvl	kraken_assigned_reads	added_reads	new_est_reads	fraction_total_reads
Streptomycetaceae	2062	F	2122537	348445	2470982	0.14630
Microbacteriaceae	85023	F	441049	49668	490717	0.02905
Micrococcaceae	1268	F	360051	67993	428044	0.02534
Intrasporangiaceae	85021	F	90336	17750	108086	0.00640
Cellulomonadaceae	85016	F	85700	22355	108055	0.00640
Promicromonosporaceae	85017	F	43015	12922	55937	0.00331
Ornithinimicrobiaceae	2805590	F	33993	5504	39497	0.00234
Dermabacteraceae	85020	F	24457	3587	28044	0.00166
Brevibacteriaceae	85019	F	22587	3552	26139	0.00155
Dermacoccaceae	145357	F	17797	3190	20987	0.00124
Bogoriellaceae	145358	F	17090	3994	21084	0.00125
Ruaniaceae	1331736	F	14396	14043	28439	0.00168
Beutenbergiaceae	125316	F	9999	2449	12448	0.00074
Sanguibacteraceae	145360	F	7075	1712	8787	0.00052
Dermatophilaceae	85018	F	3099	231	3330	0.00020
Kytococcaceae	2805426	F	2864	821	3685	0.00022
Demequinaceae	1042322	F	1048	64	1112	0.00007
Nocardioidaceae	85015	F	763990	121096	885086	0.05240
Propionibacteriaceae	31957	F	77566	14172	91738	0.00543
Kribbellaceae	2726069	F	73727	8431	82158	0.00486
Actinopolymorphaceae	2805400	F	10522	913	11435	0.00068
Micromonosporaceae	28056	F	794024	81117	875141	0.05181
Mycobacteriaceae	1762	F	350994	52556	403550	0.02389
Nocardiaceae	85025	F	228870	35905	264775	0.01568
Corynebacteriaceae	1653	F	59776	11283	71059	0.00421
Gordoniaceae	85026	F	53820	8996	62816	0.00372
Tsukamurellaceae	85028	F	17112	3367	20479	0.00121
Dietziaceae	85029	F	9407	8426	17833	0.00106
Segniliparaceae	316606	F	1344	57	1401	0.00008
Pseudonocardiaceae	2070	F	599374	71407	670781	0.03971
Thermomonosporaceae	2012	F	185038	26963	212001	0.01255
Streptosporangiaceae	2004	F	103874	12955	116829	0.00692
Nocardiopsaceae	83676	F	37962	4812	42774	0.00253
Geodermatophilaceae	85030	F	106056	20517	126573	0.00749
Actinomycetaceae	2049	F	39330	4414	43744	0.00259
Frankiaceae	74712	F	37695	2848	40543	0.00240
Nakamurellaceae	85031	F	36453	4468	40921	0.00242
Jiangellaceae	1217100	F	26609	3617	30226	0.00179
Bifidobacteriaceae	31953	F	15414	3079	18493	0.00109
Catenulisporaceae	414877	F	9758	1089	10847	0.00064
Jatrophihabitantaceae	2805416	F	7712	517	8229	0.00049
Glycomycetaceae	85034	F	6040	374	6414	0.00038
Kineosporiaceae	83778	F	5248	1110	6358	0.00038
Sporichthyaceae	85033	F	3044	1120	4164	0.00025
Actinopolysporaceae	622451	F	2423	190	2613	0.00015
Acidothermaceae	85032	F	1647	65	1712	0.00010
Conexibacteraceae	320583	F	148928	17265	166193	0.00984
Miltoncostaeaceae	2843199	F	30856	3114	33970	0.00201
Baekduiaceae	2600303	F	61735	8019	69754	0.00413
Rubrobacteraceae	84997	F	24005	787	24792	0.00147
Iamiaceae	633392	F	45725	4537	50262	0.00298
Ilumatobacteraceae	2448023	F	5117	263	5380	0.00032
Acidimicrobiaceae	84994	F	1853	121	1974	0.00012
Eggerthellaceae	1643826	F	13482	1643	15125	0.00090
Atopobiaceae	1643824	F	6552	1122	7674	0.00045
Coriobacteriaceae	84107	F	2863	510	3373	0.00020
Egibacteraceae	1747769	F	5742	257	5999	0.00036
Euzebyaceae	908622	F	5343	330	5673	0.00034
Egicoccaceae	1755824	F	5085	593	5678	0.00034
Paenibacillaceae	186822	F	59447	4716	64163	0.00380
Bacillaceae	186817	F	41199	25328	66527	0.00394
Alicyclobacillaceae	186823	F	5766	713	6479	0.00038
Planococcaceae	186818	F	2824	719	3543	0.00021
Thermoactinomycetaceae	186824	F	1946	1974	3920	0.00023
Staphylococcaceae	90964	F	1372	6445	7817	0.00046
Lactobacillaceae	33958	F	4251	1128	5379	0.00032
Streptococcaceae	1300	F	1573	717	2290	0.00014
Oscillospiraceae	216572	F	9678	3674	13352	0.00079
Clostridiales Family XVII. Incertae Sedis	539000	F	6401	1485	7886	0.00047
Lachnospiraceae	186803	F	3015	834	3849	0.00023
Symbiobacteriaceae	543349	F	2689	166	2855	0.00017
Clostridiaceae	31979	F	2141	303	2444	0.00014
Peptococcaceae	186807	F	1651	123	1774	0.00011
Thermoanaerobacteraceae	186814	F	3213	477	3690	0.00022
Selenomonadaceae	1843491	F	3494	147	3641	0.00022
Veillonellaceae	31977	F	1160	264	1424	0.00008
Limnochordaceae	1676650	F	2518	70	2588	0.00015
Deinococcaceae	183710	F	31649	1298	32947	0.00195
Thermaceae	188786	F	11582	527	12109	0.00072
Trueperaceae	332247	F	2220	89	2309	0.00014
Synechococcaceae	1890426	F	14588	1425	16013	0.00095
Prochlorococcaceae	2881426	F	3477	622	4099	0.00024
Nostocaceae	1162	F	2717	941	3658	0.00022
Calotrichaceae	2661849	F	1190	150	1340	0.00008
Leptolyngbyaceae	1890438	F	3393	243	3636	0.00022
Gloeobacteraceae	1890422	F	4428	92	4520	0.00027
Sphaerobacteraceae	85002	F	5896	263	6159	0.00036
Thermomicrobiaceae	189777	F	1536	25	1561	0.00009
Roseiflexaceae	1508635	F	4691	207	4898	0.00029
Chloroflexaceae	1106	F	1553	53	1606	0.00010
Ardenticatenaceae	1382930	F	3697	53	3750	0.00022
Tepidiformaceae	2682227	F	3487	105	3592	0.00021
Caldilineaceae	475964	F	1844	87	1931	0.00011
Anaerolineaceae	292628	F	1366	19	1385	0.00008
Ktedonosporobacteraceae	2692416	F	1260	791	2051	0.00012
Fimbriimonadaceae	1663426	F	2521	10	2531	0.00015
Bradyrhizobiaceae	41294	F	834233	61454	895687	0.05303
Phyllobacteriaceae	69277	F	253532	35526	289058	0.01711
Rhizobiaceae	82115	F	194664	36085	230749	0.01366
Hyphomicrobiaceae	45401	F	139797	10295	150092	0.00889
Methylobacteriaceae	119045	F	138669	16742	155411	0.00920
Xanthobacteraceae	335928	F	115027	14263	129290	0.00765
Boseaceae	2831100	F	87593	11483	99076	0.00587
Devosiaceae	2831106	F	38782	2606	41388	0.00245
Aurantimonadaceae	255475	F	29738	31309	61047	0.00361
Methylocystaceae	31993	F	22524	1482	24006	0.00142
Phreatobacteraceae	2843305	F	18653	2426	21079	0.00125
Stappiaceae	2821832	F	16931	2914	19845	0.00117
Beijerinckiaceae	45404	F	11281	637	11918	0.00071
Blastochloridaceae	2831090	F	10743	1965	12708	0.00075
Parvibaculaceae	2813035	F	10009	1947	11956	0.00071
Chelatococcaceae	2036754	F	9381	1637	11018	0.00065
Brucellaceae	118882	F	7286	9290	16576	0.00098
Kaistiaceae	2831111	F	6085	1163	7248	0.00043
Amorphaceae	2685818	F	5693	481	6174	0.00037
Lichenihabitantaceae	2723775	F	3708	138	3846	0.00023
Breoghaniaceae	2831104	F	3591	368	3959	0.00023
Pleomorphomonadaceae	2843308	F	3542	490	4032	0.00024
Sphingomonadaceae	41297	F	562736	76408	639144	0.03784
Erythrobacteraceae	335929	F	75017	11442	86459	0.00512
Sphingosinicellaceae	2820280	F	18647	1180	19827	0.00117
Azospirillaceae	2829815	F	75257	6257	81514	0.00483
Acetobacteraceae	433	F	69957	6544	76501	0.00453
Rhodospirillaceae	41295	F	40932	139814	180746	0.01070
Stellaceae	2844601	F	7733	414	8147	0.00048
Elioraeaceae	2690195	F	3846	147	3993	0.00024
Thalassospiraceae	2844866	F	2723	147	2870	0.00017
Rhodobacteraceae	31989	F	95727	10618	106345	0.00630
Roseobacteraceae	2854170	F	67214	5973	73187	0.00433
Caulobacteraceae	76892	F	130860	10187	141047	0.00835
Maricaulaceae	2800061	F	5439	428	5867	0.00035
Hyphomonadaceae	69657	F	4804	149	4953	0.00029
Parvularculaceae	255474	F	1818	95	1913	0.00011
Comamonadaceae	80864	F	441022	109904	550926	0.03262
Burkholderiaceae	119060	F	425713	129722	555435	0.03289
Oxalobacteraceae	75682	F	161426	17876	179302	0.01062
Alcaligenaceae	506	F	110741	138553	249294	0.01476
Sutterellaceae	995019	F	2096	141	2237	0.00013
Nitrosomonadaceae	206379	F	59385	1702	61087	0.00362
Usitatibacteraceae	2803844	F	17499	1163	18662	0.00110
Sterolibacteriaceae	2008793	F	11302	2590	13892	0.00082
Gallionellaceae	90627	F	7512	722	8234	0.00049
Sulfuricellaceae	2772226	F	6455	700	7155	0.00042
Thiobacillaceae	2008790	F	5809	1411	7220	0.00043
Methylophilaceae	32011	F	4607	295	4902	0.00029
Zoogloeaceae	2008794	F	35744	11897	47641	0.00282
Rhodocyclaceae	75787	F	26611	7022	33633	0.00199
Azonexaceae	2008795	F	10378	945	11323	0.00067
Chromobacteriaceae	1499392	F	34960	5750	40710	0.00241
Neisseriaceae	481	F	15297	2604	17901	0.00106
Casimicrobiaceae	2705999	F	2119	891	3010	0.00018
Xanthomonadaceae	32033	F	356889	51936	408825	0.02421
Rhodanobacteraceae	1775411	F	80287	9746	90033	0.00533
Pseudomonadaceae	135621	F	368104	101119	469223	0.02778
Marinobacteraceae	2887365	F	6872	484	7356	0.00044
Enterobacteriaceae	543	F	47457	113333	160790	0.00952
Yersiniaceae	1903411	F	18743	12498	31241	0.00185
Erwiniaceae	1903409	F	14286	1936	16222	0.00096
Pectobacteriaceae	1903410	F	8647	962	9609	0.00057
Hafniaceae	1903412	F	2664	820	3484	0.00021
Morganellaceae	1903414	F	2437	1022	3459	0.00020
Bruguierivoracaceae	2812006	F	1640	87	1727	0.00010
Ectothiorhodospiraceae	72276	F	24186	1679	25865	0.00153
Chromatiaceae	1046	F	18060	962	19022	0.00113
Wenzhouxiangellaceae	1676141	F	2805	2382	5187	0.00031
Thioalkalibacteraceae	2035710	F	1634	302	1936	0.00011
Thioalkalispiraceae	1096778	F	1574	454	2028	0.00012
Halothiobacillaceae	255526	F	1089	69	1158	0.00007
Halomonadaceae	28256	F	41427	3767	45194	0.00268
Alcanivoracaceae	224372	F	4436	1553	5989	0.00035
Oceanospirillaceae	135620	F	3192	265	3457	0.00020
Hahellaceae	224379	F	1010	30	1040	0.00006
Aeromonadaceae	84642	F	21164	14072	35236	0.00209
Methylococcaceae	403	F	19298	650	19948	0.00118
Shewanellaceae	267890	F	6226	893	7119	0.00042
Alteromonadaceae	72275	F	2865	289	3154	0.00019
Pseudoalteromonadaceae	267888	F	2068	195	2263	0.00013
Microbulbiferaceae	1706373	F	5530	254	5784	0.00034
Cellvibrionaceae	1706371	F	2587	70	2657	0.00016
Halieaceae	1706372	F	2421	188	2609	0.00015
Spongiibacteraceae	1706375	F	1229	80	1309	0.00008
Sinobacteraceae	568386	F	7927	775	8702	0.00052
Steroidobacteraceae	2689614	F	3806	780	4586	0.00027
Acidiferrobacteraceae	1692041	F	9833	363	10196	0.00060
Vibrionaceae	641	F	7796	1414	9210	0.00055
Legionellaceae	444	F	3532	233	3765	0.00022
Coxiellaceae	118968	F	1294	24	1318	0.00008
Moraxellaceae	468	F	4694	1368	6062	0.00036
Immundisolibacteraceae	1934946	F	3792	539	4331	0.00026
Piscirickettsiaceae	135616	F	1718	126	1844	0.00011
Thiotrichaceae	135617	F	1117	28	1145	0.00007
Pasteurellaceae	712	F	2064	920	2984	0.00018
Salinisphaeraceae	742031	F	1865	1574	3439	0.00020
Cardiobacteriaceae	868	F	1216	128	1344	0.00008
Myxococcaceae	31	F	64242	33476	97718	0.00579
Anaeromyxobacteraceae	1524215	F	58513	3367	61880	0.00366
Archangiaceae	39	F	51513	2054	53567	0.00317
Vulgatibacteraceae	1524213	F	7031	426	7457	0.00044
Polyangiaceae	49	F	105329	6805	112134	0.00664
Sandaracinaceae	1055686	F	36252	1692	37944	0.00225
Labilitrichaceae	1524216	F	18252	766	19018	0.00113
Kofleriaceae	224464	F	13905	568	14473	0.00086
Geobacteraceae	213422	F	25142	1947	27089	0.00160
Desulfuromonadaceae	213421	F	7667	929	8596	0.00051
Syntrophotaleaceae	2812024	F	1394	132	1526	0.00009
Desulfovibrionaceae	194924	F	24327	1685	26012	0.00154
Desulfomicrobiaceae	213116	F	1305	109	1414	0.00008
Desulfobacteraceae	213119	F	5677	399	6076	0.00036
Desulfobulbaceae	213121	F	2492	279	2771	0.00016
Bradymonadaceae	1779135	F	6995	853	7848	0.00046
Syntrophobacteraceae	213465	F	1909	338	2247	0.00013
Desulfarculaceae	453228	F	1797	741	2538	0.00015
Syntrophaceae	213468	F	1167	191	1358	0.00008
Campylobacteraceae	72294	F	1236	169	1405	0.00008
Acidithiobacillaceae	225058	F	2434	197	2631	0.00016
Bdellovibrionaceae	213483	F	1941	19	1960	0.00012
Gemmatimonadaceae	219687	F	151146	6902	158048	0.00936
Hymenobacteraceae	1853232	F	29285	997	30282	0.00179
Cytophagaceae	89373	F	5419	205	5624	0.00033
Spirosomaceae	2896860	F	3710	160	3870	0.00023
Fulvivirgaceae	2762286	F	1439	35	1474	0.00009
Cyclobacteriaceae	563798	F	1067	88	1155	0.00007
Chitinophagaceae	563835	F	24752	247	24999	0.00148
Flavobacteriaceae	49546	F	16141	891	17032	0.00101
Weeksellaceae	2762318	F	3637	722	4359	0.00026
Sphingobacteriaceae	84566	F	19587	1097	20684	0.00122
Rikenellaceae	171550	F	5966	1532	7498	0.00044
Prevotellaceae	171552	F	2521	281	2802	0.00017
Bacteroidaceae	815	F	2323	724	3047	0.00018
Tannerellaceae	2005525	F	1169	286	1455	0.00009
Rhodothermaceae	563843	F	11404	436	11840	0.00070
Chlorobiaceae	191412	F	4453	509	4962	0.00029
Gemmataceae	1914233	F	56806	1719	58525	0.00347
Pirellulaceae	2691357	F	23389	876	24265	0.00144
Lacipirellulaceae	2691359	F	18907	762	19669	0.00116
Planctomycetaceae	126	F	36082	2728	38810	0.00230
Isosphaeraceae	1763524	F	34918	3296	38214	0.00226
Tepidisphaeraceae	1771355	F	9238	215	9453	0.00056
Phycisphaeraceae	666507	F	5759	321	6080	0.00036
Opitutaceae	134623	F	51609	1745	53354	0.00316
Puniceicoccaceae	415002	F	1231	109	1340	0.00008
Verrucomicrobiaceae	203557	F	15491	423	15914	0.00094
Akkermansiaceae	1647988	F	1772	1742	3514	0.00021
Kiritimatiellaceae	1921783	F	1034	960	1994	0.00012
Acidobacteriaceae	204434	F	37337	703	38040	0.00225
Bryobacteraceae	1962910	F	7518	184	7702	0.00046
Vicinamibacteraceae	2211325	F	41381	5987	47368	0.00280
Acanthopleuribacteraceae	533207	F	2362	41	2403	0.00014
Nitrospiraceae	189779	F	18055	224	18279	0.00108
Treponemataceae	2845253	F	1376	171	1547	0.00009
Spirochaetaceae	137	F	1259	26	1285	0.00008
Leptospiraceae	170	F	1177	42	1219	0.00007
Synergistaceae	649777	F	3646	245	3891	0.00023
Nectriaceae	110618	F	9911	461	10372	0.00061
Hypocreaceae	5129	F	6508	198	6706	0.00040
Cordycipitaceae	474943	F	5771	116	5887	0.00035
Clavicipitaceae	34397	F	4795	329	5124	0.00030
Ophiocordycipitaceae	474942	F	3380	116	3496	0.00021
Glomerellaceae	681950	F	1978	282	2260	0.00013
Chaetomiaceae	35718	F	3731	76	3807	0.00023
Pyriculariaceae	2528436	F	2551	18	2569	0.00015
Sporocadaceae	1812776	F	1236	13	1249	0.00007
Aspergillaceae	1131492	F	3361	119	3480	0.00021
Saccharomycetaceae	4893	F	1359	210	1569	0.00009
Ustilaginaceae	5268	F	4374	99	4473	0.00026
Phanerochaetaceae	396331	F	1077	10	1087	0.00006
Peronosporaceae	4777	F	8645	875	9520	0.00056
