name	taxonomy_id	taxonomy_lvl	kraken_assigned_reads	added_reads	new_est_reads	fraction_total_reads
Streptomycetales	85011	O	1879856	363023	2242879	0.14756
Micrococcales	85006	O	985747	128103	1113850	0.07328
Corynebacteriales	85007	O	721588	88782	810370	0.05332
Propionibacteriales	85009	O	701035	113348	814383	0.05358
Micromonosporales	85008	O	674463	76652	751115	0.04942
Pseudonocardiales	85010	O	662417	88973	751390	0.04944
Streptosporangiales	85012	O	344628	49028	393656	0.02590
Geodermatophilales	1643682	O	99183	22020	121203	0.00797
Frankiales	85013	O	38526	3421	41947	0.00276
Actinomycetales	2037	O	36133	4680	40813	0.00269
Jiangellales	1217098	O	22601	3521	26122	0.00172
Bifidobacteriales	85004	O	14398	3423	17821	0.00117
Nakamurellales	1643684	O	13238	1497	14735	0.00097
Catenulisporales	414714	O	10209	1309	11518	0.00076
Jatrophihabitantales	2805415	O	7544	581	8125	0.00053
Glycomycetales	85014	O	5543	393	5936	0.00039
Kineosporiales	622452	O	4681	1139	5820	0.00038
Sporichthyales	2495578	O	2927	1231	4158	0.00027
Actinopolysporales	622450	O	2200	198	2398	0.00016
Acidothermales	1643683	O	1636	74	1710	0.00011
Solirubrobacterales	588673	O	163501	22038	185539	0.01221
Miltoncostaeales	2843198	O	34887	4110	38997	0.00257
Rubrobacterales	84996	O	89101	10714	99815	0.00657
Acidimicrobiales	84993	O	51303	5081	56384	0.00371
Eggerthellales	1643822	O	12491	1853	14344	0.00094
Coriobacteriales	84999	O	9243	1684	10927	0.00072
Egibacterales	1747768	O	5447	286	5733	0.00038
Egicoccales	1755823	O	4745	652	5397	0.00036
Euzebyales	908621	O	4638	338	4976	0.00033
Bacillales	1385	O	134915	69621	204536	0.01346
Lactobacillales	186826	O	6575	2496	9071	0.00060
Eubacteriales	186802	O	30885	5427	36312	0.00239
Thermoanaerobacterales	68295	O	3681	494	4175	0.00027
Selenomonadales	909929	O	4078	209	4287	0.00028
Veillonellales	1843489	O	1144	291	1435	0.00009
Limnochordales	1676649	O	2544	85	2629	0.00017
Deinococcales	118964	O	29383	1414	30797	0.00203
Thermales	68933	O	11123	611	11734	0.00077
Trueperales	2762275	O	2148	98	2246	0.00015
Synechococcales	1890424	O	18876	1404	20280	0.00133
Nostocales	1161	O	6071	413	6484	0.00043
Pseudanabaenales	2881377	O	4376	235	4611	0.00030
Gloeobacterales	307595	O	4149	78	4227	0.00028
Oscillatoriales	1150	O	2577	218	2795	0.00018
Sphaerobacterales	85001	O	6521	353	6874	0.00045
Thermomicrobiales	189776	O	1526	32	1558	0.00010
Chloroflexales	32064	O	6195	186	6381	0.00042
Tepidiformales	2682226	O	4219	149	4368	0.00029
Ardenticatenales	1382929	O	3672	62	3734	0.00025
Caldilineales	475963	O	1850	98	1948	0.00013
Ktedonobacterales	388448	O	1578	39	1617	0.00011
Anaerolineales	292629	O	1331	826	2157	0.00014
Fimbriimonadales	1663425	O	2429	12	2441	0.00016
Hyphomicrobiales	356	O	1969399	106800	2076199	0.13660
Sphingomonadales	204457	O	466564	47053	513617	0.03379
Rhodospirillales	204441	O	209631	174980	384611	0.02530
Rhodobacterales	204455	O	159381	11410	170791	0.01124
Caulobacterales	204458	O	110213	9489	119702	0.00788
Hyphomonadales	2800060	O	5347	183	5530	0.00036
Maricaulales	2800059	O	5100	471	5571	0.00037
Parvularculales	255473	O	1708	107	1815	0.00012
Burkholderiales	80840	O	1090165	268690	1358855	0.08940
Rhodocyclales	206389	O	72065	19656	91721	0.00603
Nitrosomonadales	32003	O	55639	6496	62135	0.00409
Neisseriales	206351	O	44879	10886	55765	0.00367
Xanthomonadales	135614	O	300312	49605	349917	0.02302
Pseudomonadales	72274	O	268589	68798	337387	0.02220
Enterobacterales	91347	O	91628	163888	255516	0.01681
Chromatiales	135613	O	52547	3753	56300	0.00370
Oceanospirillales	135619	O	48429	6230	54659	0.00360
Aeromonadales	135624	O	19005	12403	31408	0.00207
Methylococcales	135618	O	17685	755	18440	0.00121
Alteromonadales	135622	O	11271	1366	12637	0.00083
Cellvibrionales	1706369	O	10698	532	11230	0.00074
Nevskiales	1775403	O	10337	1767	12104	0.00080
Acidiferrobacterales	1692040	O	9989	457	10446	0.00069
Vibrionales	135623	O	6704	2137	8841	0.00058
Moraxellales	2887326	O	3550	1076	4626	0.00030
Legionellales	118969	O	3065	161	3226	0.00021
Immundisolibacterales	1934945	O	3029	3287	6316	0.00042
Thiotrichales	72273	O	2468	139	2607	0.00017
Salinisphaerales	742030	O	1769	69	1838	0.00012
Pasteurellales	135625	O	1449	1964	3413	0.00022
Cardiobacteriales	135615	O	1079	147	1226	0.00008
Myxococcales	29	O	406951	27384	434335	0.02858
Desulfuromonadales	69541	O	35230	2747	37977	0.00250
Desulfovibrionales	213115	O	25477	1944	27421	0.00180
Desulfobacterales	213118	O	9222	747	9969	0.00066
Bradymonadales	1779134	O	7653	203	7856	0.00052
Syntrophobacterales	213462	O	2015	449	2464	0.00016
Desulfarculales	453227	O	1864	949	2813	0.00019
Syntrophales	2914038	O	1020	274	1294	0.00009
Campylobacterales	213849	O	3830	194	4024	0.00026
Acidithiobacillales	225057	O	2088	214	2302	0.00015
Bdellovibrionales	213481	O	1328	17	1345	0.00009
Gemmatales	2691355	O	55530	1773	57303	0.00377
Pirellulales	2691354	O	41412	1016	42428	0.00279
Isosphaerales	2691356	O	36912	3732	40644	0.00267
Planctomycetales	112	O	33194	2833	36027	0.00237
Tepidisphaerales	1771349	O	8960	257	9217	0.00061
Phycisphaerales	666506	O	5595	371	5966	0.00039
Opitutales	415000	O	26733	1174	27907	0.00184
Puniceicoccales	415001	O	1068	124	1192	0.00008
Verrucomicrobiales	48461	O	12074	2077	14151	0.00093
Cytophagales	768507	O	37008	748	37756	0.00248
Chitinophagales	1853229	O	24071	247	24318	0.00160
Bacteroidales	171549	O	13503	2641	16144	0.00106
Flavobacteriales	200644	O	12054	900	12954	0.00085
Bacteroidetes Order II. Incertae sedis	1100069	O	10610	457	11067	0.00073
Sphingobacteriales	200666	O	8746	632	9378	0.00062
Chlorobiales	191411	O	4136	513	4649	0.00031
Gemmatimonadales	219686	O	110576	5876	116452	0.00766
Acidobacteriales	204433	O	45818	940	46758	0.00308
Bryobacterales	332160	O	8610	226	8836	0.00058
Vicinamibacterales	2910145	O	46426	6470	52896	0.00348
Acanthopleuribacterales	533206	O	2269	46	2315	0.00015
Nitrospirales	189778	O	12098	171	12269	0.00081
Spirochaetales	136	O	3296	216	3512	0.00023
Leptospirales	1643688	O	1057	10	1067	0.00007
Synergistales	649776	O	3420	1017	4437	0.00029
Hypocreales	5125	O	31109	611	31720	0.00209
Glomerellales	1028384	O	1784	267	2051	0.00013
Sordariales	5139	O	3937	74	4011	0.00026
Magnaporthales	639021	O	2313	15	2328	0.00015
Xylariales	37989	O	1059	10	1069	0.00007
Eurotiales	5042	O	3787	105	3892	0.00026
Pleosporales	92860	O	1045	207	1252	0.00008
Saccharomycetales	4892	O	2025	229	2254	0.00015
Ustilaginales	5267	O	3811	87	3898	0.00026
Peronosporales	4776	O	7344	998	8342	0.00055
