name	taxonomy_id	taxonomy_lvl	kraken_assigned_reads	added_reads	new_est_reads	fraction_total_reads
Streptomycetaceae	2062	F	195849	41255	237104	0.14527
Microbacteriaceae	85023	F	49070	6069	55139	0.03378
Micrococcaceae	1268	F	24317	5339	29656	0.01817
Intrasporangiaceae	85021	F	10895	2573	13468	0.00825
Cellulomonadaceae	85016	F	9206	2914	12120	0.00743
Promicromonosporaceae	85017	F	4523	1625	6148	0.00377
Ornithinimicrobiaceae	2805590	F	3978	779	4757	0.00291
Dermabacteraceae	85020	F	2687	482	3169	0.00194
Brevibacteriaceae	85019	F	2507	469	2976	0.00182
Dermacoccaceae	145357	F	2142	466	2608	0.00160
Bogoriellaceae	145358	F	1911	542	2453	0.00150
Ruaniaceae	1331736	F	1614	1602	3216	0.00197
Beutenbergiaceae	125316	F	1079	315	1394	0.00085
Nocardioidaceae	85015	F	80705	15350	96055	0.05885
Propionibacteriaceae	31957	F	8404	1473	9877	0.00605
Kribbellaceae	2726069	F	5658	777	6435	0.00394
Actinopolymorphaceae	2805400	F	1429	149	1578	0.00097
Mycobacteriaceae	1762	F	47046	5793	52839	0.03237
Nocardiaceae	85025	F	23868	4309	28177	0.01726
Corynebacteriaceae	1653	F	6635	1546	8181	0.00501
Gordoniaceae	85026	F	5804	1161	6965	0.00427
Tsukamurellaceae	85028	F	1782	418	2200	0.00135
Dietziaceae	85029	F	1059	965	2024	0.00124
Pseudonocardiaceae	2070	F	62210	9116	71326	0.04370
Micromonosporaceae	28056	F	49421	6077	55498	0.03400
Thermomonosporaceae	2012	F	19291	3436	22727	0.01393
Streptosporangiaceae	2004	F	10221	1554	11775	0.00721
Nocardiopsaceae	83676	F	4143	593	4736	0.00290
Geodermatophilaceae	85030	F	15211	3561	18772	0.01150
Actinomycetaceae	2049	F	4258	589	4847	0.00297
Frankiaceae	74712	F	4192	393	4585	0.00281
Jiangellaceae	1217100	F	2866	467	3333	0.00204
Nakamurellaceae	85031	F	1885	235	2120	0.00130
Bifidobacteriaceae	31953	F	1650	353	2003	0.00123
Catenulisporaceae	414877	F	1168	158	1326	0.00081
Jatrophihabitantaceae	2805416	F	1082	88	1170	0.00072
Conexibacteraceae	320583	F	20065	2912	22977	0.01408
Miltoncostaeaceae	2843199	F	4153	540	4693	0.00288
Baekduiaceae	2600303	F	7641	1266	8907	0.00546
Rubrobacteraceae	84997	F	3085	132	3217	0.00197
Iamiaceae	633392	F	5098	648	5746	0.00352
Eggerthellaceae	1643826	F	1473	260	1733	0.00106
Bacillaceae	186817	F	7585	7133	14718	0.00902
Paenibacillaceae	186822	F	6413	599	7012	0.00430
Oscillospiraceae	216572	F	1019	514	1533	0.00094
Deinococcaceae	183710	F	3538	325	3863	0.00237
Thermaceae	188786	F	1273	72	1345	0.00082
Synechococcaceae	1890426	F	1617	321	1938	0.00119
Bradyrhizobiaceae	41294	F	83710	8320	92030	0.05639
Phyllobacteriaceae	69277	F	22699	4171	26870	0.01646
Rhizobiaceae	82115	F	21036	3892	24928	0.01527
Methylobacteriaceae	119045	F	15719	2323	18042	0.01105
Xanthobacteraceae	335928	F	10989	1699	12688	0.00777
Hyphomicrobiaceae	45401	F	9257	798	10055	0.00616
Boseaceae	2831100	F	4082	592	4674	0.00286
Devosiaceae	2831106	F	3470	283	3753	0.00230
Aurantimonadaceae	255475	F	3251	3497	6748	0.00413
Methylocystaceae	31993	F	2594	204	2798	0.00171
Phreatobacteraceae	2843305	F	1862	295	2157	0.00132
Stappiaceae	2821832	F	1843	357	2200	0.00135
Beijerinckiaceae	45404	F	1226	82	1308	0.00080
Parvibaculaceae	2813035	F	1191	270	1461	0.00090
Blastochloridaceae	2831090	F	1148	248	1396	0.00086
Chelatococcaceae	2036754	F	1035	216	1251	0.00077
Sphingomonadaceae	41297	F	42638	5395	48033	0.02943
Erythrobacteraceae	335929	F	6884	1198	8082	0.00495
Sphingosinicellaceae	2820280	F	1910	135	2045	0.00125
Azospirillaceae	2829815	F	9901	1013	10914	0.00669
Acetobacteraceae	433	F	9296	1130	10426	0.00639
Rhodospirillaceae	41295	F	5331	25074	30405	0.01863
Stellaceae	2844601	F	1143	75	1218	0.00075
Rhodobacteraceae	31989	F	10556	1316	11872	0.00727
Roseobacteraceae	2854170	F	7361	724	8085	0.00495
Caulobacteraceae	76892	F	9919	907	10826	0.00663
Burkholderiaceae	119060	F	46349	10329	56678	0.03473
Comamonadaceae	80864	F	28806	10414	39220	0.02403
Oxalobacteraceae	75682	F	13853	1990	15843	0.00971
Alcaligenaceae	506	F	11843	13377	25220	0.01545
Zoogloeaceae	2008794	F	3895	1757	5652	0.00346
Rhodocyclaceae	75787	F	2955	1016	3971	0.00243
Azonexaceae	2008795	F	1095	128	1223	0.00075
Usitatibacteraceae	2803844	F	2929	286	3215	0.00197
Sterolibacteriaceae	2008793	F	1143	379	1522	0.00093
Chromobacteriaceae	1499392	F	3620	778	4398	0.00269
Neisseriaceae	481	F	1484	304	1788	0.00110
Xanthomonadaceae	32033	F	25466	5164	30630	0.01877
Rhodanobacteraceae	1775411	F	7548	1213	8761	0.00537
Pseudomonadaceae	135621	F	28748	8986	37734	0.02312
Enterobacteriaceae	543	F	4766	18239	23005	0.01410
Yersiniaceae	1903411	F	1910	475	2385	0.00146
Erwiniaceae	1903409	F	1474	256	1730	0.00106
Ectothiorhodospiraceae	72276	F	2572	249	2821	0.00173
Chromatiaceae	1046	F	1945	151	2096	0.00128
Halomonadaceae	28256	F	4413	549	4962	0.00304
Aeromonadaceae	84642	F	2178	1388	3566	0.00219
Methylococcaceae	403	F	1902	84	1986	0.00122
Acidiferrobacteraceae	1692041	F	1140	55	1195	0.00073
Anaeromyxobacteraceae	1524215	F	7466	694	8160	0.00500
Myxococcaceae	31	F	6779	834	7613	0.00466
Archangiaceae	39	F	4989	626	5615	0.00344
Polyangiaceae	49	F	13396	1198	14594	0.00894
Sandaracinaceae	1055686	F	3757	223	3980	0.00244
Labilitrichaceae	1524216	F	2210	106	2316	0.00142
Kofleriaceae	224464	F	1676	114	1790	0.00110
Geobacteraceae	213422	F	3075	435	3510	0.00215
Desulfovibrionaceae	194924	F	2778	365	3143	0.00193
Gemmataceae	1914233	F	11421	384	11805	0.00723
Isosphaeraceae	1763524	F	9920	894	10814	0.00663
Pirellulaceae	2691357	F	3006	114	3120	0.00191
Lacipirellulaceae	2691359	F	2631	122	2753	0.00169
Planctomycetaceae	126	F	5361	558	5919	0.00363
Opitutaceae	134623	F	2354	128	2482	0.00152
Verrucomicrobiaceae	203557	F	1197	73	1270	0.00078
Hymenobacteraceae	1853232	F	2849	243	3092	0.00189
Chitinophagaceae	563835	F	2459	110	2569	0.00157
Flavobacteriaceae	49546	F	1019	193	1212	0.00074
Rhodothermaceae	563843	F	1259	76	1335	0.00082
Gemmatimonadaceae	219687	F	11340	664	12004	0.00736
Acidobacteriaceae	204434	F	6358	139	6497	0.00398
Bryobacteraceae	1962910	F	1181	31	1212	0.00074
Vicinamibacteraceae	2211325	F	5846	765	6611	0.00405
Nitrospiraceae	189779	F	1309	19	1328	0.00081
Nectriaceae	110618	F	2529	486	3015	0.00185
