name	taxonomy_id	taxonomy_lvl	kraken_assigned_reads	added_reads	new_est_reads	fraction_total_reads
Streptomyces sp. BH-MK-02	2880933	S	33793	6899	40692	0.00213
Streptomyces sp. A2-16	2781734	S	33500	10618	44118	0.00231
Streptomyces sp. CdTB01	1725411	S	27569	7806	35375	0.00185
Streptomyces sp. P3	2135430	S	18875	4751	23626	0.00124
Streptomyces sp. SN-593	659352	S	17128	3550	20678	0.00108
Streptomyces sp. ZYC-3	2797636	S	14827	2973	17800	0.00093
Streptomyces sp. 3214.6	1882757	S	14792	4359	19151	0.00100
Streptomyces sp. CB01881	2078691	S	14263	2384	16647	0.00087
Streptomyces sp. GQFP	2907545	S	13646	2313	15959	0.00084
Streptomyces sp. Z423-1	2730915	S	12194	3549	15743	0.00082
Streptomyces sp. So13.3	2136173	S	11995	2016	14011	0.00073
Streptomyces sp. ST1015	1848900	S	11969	2423	14392	0.00075
Streptomyces sp. WAC 01438	2203204	S	11732	3888	15620	0.00082
Streptomyces sp. SAT1	1849967	S	11226	3986	15212	0.00080
Streptomyces sp. SCSIO 64649	2878388	S	11161	1755	12916	0.00068
Streptomyces sp. LRE541	2931983	S	10851	2491	13342	0.00070
Streptomyces sp. BJ20	2930049	S	10657	4230	14887	0.00078
Streptomyces sp. RPA4-2	2721244	S	10104	3031	13135	0.00069
Streptomyces sp. NEAU-sy36	2751189	S	9744	3592	13336	0.00070
Streptomyces sp. DSM 40868	2721173	S	9698	3546	13244	0.00069
Streptomyces sp. CMB-StM0423	2059884	S	9620	6125	15745	0.00082
Streptomyces sp. Go 40/10	2825844	S	9402	4325	13727	0.00072
Streptomyces sp. NHF165	2175864	S	9176	1432	10608	0.00056
Streptomyces sp. NA02950	2742137	S	8963	1676	10639	0.00056
Streptomyces sp. AMCC400023	2056258	S	8893	4026	12919	0.00068
Streptomyces sp. HM190	2695266	S	8891	2779	11670	0.00061
Streptomyces sp. MG62	2838015	S	8804	3361	12165	0.00064
Streptomyces sp. JB150	2714844	S	8637	2910	11547	0.00060
Streptomyces sp. MA3_2.13	2867410	S	8500	957	9457	0.00050
Streptomyces sp. MG28	2865673	S	8236	3206	11442	0.00060
Streptomyces sp. Go-475	2072505	S	8084	3828	11912	0.00062
Streptomyces sp. S1D4-11	2721246	S	8063	7153	15216	0.00080
Streptomyces sp. 3025	2923272	S	8019	1299	9318	0.00049
Streptomyces sp. S4.7	2705439	S	7801	2556	10357	0.00054
Streptomyces sp. SCUT-3	2684469	S	7776	2659	10435	0.00055
Streptomyces sp. YIM 121038	2136401	S	7772	2259	10031	0.00053
Streptomyces sp. MBT27	1488356	S	7731	2108	9839	0.00052
Streptomyces sp. GMY02	1333528	S	7288	1188	8476	0.00044
Streptomyces sp. 891-h	2720714	S	7288	1220	8508	0.00045
Streptomyces sp. RTd22	1841249	S	7263	3996	11259	0.00059
Streptomyces sp. W1SF4	2305220	S	7177	2450	9627	0.00050
Streptomyces sp. NA04227	2742136	S	7167	1500	8667	0.00045
Streptomyces sp. GS7	2692234	S	7090	1845	8935	0.00047
Streptomyces sp. SYP-A7193	2662065	S	6798	4658	11456	0.00060
Streptomyces sp. CB09001	2083284	S	6655	4719	11374	0.00060
Streptomyces sp. jing01	2726118	S	6599	3745	10344	0.00054
Streptomyces sp. MST-110588	2833628	S	6546	1462	8008	0.00042
Streptomyces sp. HP-A2021	2927875	S	6476	3721	10197	0.00053
Streptomyces sp. C8S0	2585716	S	6408	1672	8080	0.00042
Streptomyces sp. HSG2	2797167	S	6397	1254	7651	0.00040
Streptomyces sp. BHT-5-2	2866715	S	6020	1854	7874	0.00041
Streptomyces sp. QHH-9511	2684468	S	5974	1554	7528	0.00039
Streptomyces sp. Rer75	2750011	S	5960	3631	9591	0.00050
Streptomyces sp. 135	2838850	S	5839	1933	7772	0.00041
Streptomyces sp. SirexAA-E	862751	S	5718	1710	7428	0.00039
Streptomyces sp. SM18	1736046	S	5667	1567	7234	0.00038
Streptomyces sp. WAC 01529	2203205	S	5302	1883	7185	0.00038
Streptomyces sp. fd1-xmd	1812480	S	5164	2491	7655	0.00040
Streptomyces sp. WAC 06738	2203210	S	4972	7293	12265	0.00064
Streptomyces sp. Tu 2975	2676871	S	4926	1499	6425	0.00034
Streptomyces sp. SUK 48	2582831	S	4796	3236	8032	0.00042
Streptomyces sp. INR7	2607753	S	4597	2695	7292	0.00038
Streptomyces sp. CNQ-509	444103	S	4436	6351	10787	0.00057
Streptomyces sp. TN58	234612	S	4428	2268	6696	0.00035
Streptomyces sp. CCM_MD2014	1561022	S	4407	4974	9381	0.00049
Streptomyces sp. ADI95-16	1522758	S	4118	5005	9123	0.00048
Streptomyces sp. HF10	2692233	S	4108	3138	7246	0.00038
Streptomyces sp. WY228	2855836	S	4073	2242	6315	0.00033
Streptomyces sp. MOE7	1961713	S	3758	4609	8367	0.00044
Streptomyces sp. Mg1	465541	S	3543	4578	8121	0.00043
Streptomyces sp. 2323.1	1938841	S	3373	2074	5447	0.00029
Streptomyces sp. AgN23	1188315	S	3254	3038	6292	0.00033
Streptomyces sp. YPW6	2840373	S	3153	1671	4824	0.00025
Streptomyces sp. RLB1-33	2721243	S	3078	10478	13556	0.00071
Streptomyces sp. 769	1262452	S	2954	2364	5318	0.00028
Streptomyces sp. RPA4-5	2721245	S	2921	1934	4855	0.00025
Streptomyces sp. EAS-AB2608	2779671	S	2862	6613	9475	0.00050
Streptomyces sp. M2	646637	S	2823	25789	28612	0.00150
Streptomyces sp. PBH53	1577075	S	2522	5657	8179	0.00043
Streptomyces sp. NA02536	2742133	S	2512	6922	9434	0.00049
Streptomyces sp. CRSS-Y-16	2906474	S	2495	24111	26606	0.00139
Streptomyces sp. NEAU-S7GS2	2202000	S	2150	2003	4153	0.00022
Streptomyces sp. S063	2005885	S	2120	1544	3664	0.00019
Streptomyces sp. 3211	1964449	S	2110	3946	6056	0.00032
Streptomyces sp. S8	1837283	S	2089	1912	4001	0.00021
Streptomyces sp. XC 2026	2782004	S	2035	1799	3834	0.00020
Streptomyces sp. ID38640	1265399	S	1998	1686	3684	0.00019
Streptomyces sp. PAMC 26508	1265601	S	1954	11911	13865	0.00073
Streptomyces sp. Sge12	1972846	S	1798	4141	5939	0.00031
Streptomyces sp. 11-1-2	1851167	S	1772	3581	5353	0.00028
Streptomyces sp. WA6-1-16	2879427	S	1748	1954	3702	0.00019
Streptomyces sp. S501	2420135	S	1707	11273	12980	0.00068
Streptomyces sp. HNA39	2850561	S	1524	1899	3423	0.00018
Streptomyces sp. Tue 6075	1661694	S	1445	1812	3257	0.00017
Streptomyces sp. CC0208	2306165	S	1417	41911	43328	0.00227
Streptomyces sp. A144	2871487	S	1416	10368	11784	0.00062
Streptomyces sp. CFMR 7	1649184	S	1385	2584	3969	0.00021
Streptomyces sp. 2114.2	1881022	S	1293	8630	9923	0.00052
Streptomyces sp. CB00271	2750025	S	1266	1826	3092	0.00016
Streptomyces sp. endophyte_N2	2153485	S	1246	3844	5090	0.00027
Streptomyces sp. M56	1495638	S	1228	3540	4768	0.00025
Streptomyces sp. CB04723	2748873	S	1109	2035	3144	0.00016
Streptomyces sp. WAC00303	2933779	S	1101	1676	2777	0.00015
Streptomyces sp. GF20	2692235	S	1030	6359	7389	0.00039
Streptomyces rapamycinicus	1226757	S	20891	4518	25409	0.00133
Streptomyces hygroscopicus	1912	S	15407	21033	36440	0.00191
Streptomyces violaceusniger	68280	S	4112	2604	6716	0.00035
Streptomyces yatensis	155177	S	3529	2469	5998	0.00031
Streptomyces venezuelae	54571	S	37992	12567	50559	0.00265
Streptomyces cadmiisoli	2184053	S	10440	2231	12671	0.00066
Streptomyces aurantiacus	47760	S	9308	1938	11246	0.00059
Streptomyces qaidamensis	1783515	S	6132	2355	8487	0.00044
Streptomyces alboniger	132473	S	4506	1507	6013	0.00031
Streptomyces koyangensis	188770	S	3093	2933	6026	0.00032
Streptomyces griseorubiginosus	67304	S	27003	7799	34802	0.00182
Streptomyces bathyalis	2710756	S	24770	3249	28019	0.00147
Streptomyces nodosus	40318	S	22931	4852	27783	0.00146
Streptomyces aquilus	2548456	S	22271	5736	28007	0.00147
Streptomyces chartreusis	1969	S	20931	7913	28844	0.00151
Streptomyces lydicus	47763	S	20131	13021	33152	0.00174
Streptomyces avermitilis	33903	S	16872	4151	21023	0.00110
Streptomyces armeniacus	83291	S	16678	1893	18571	0.00097
Streptomyces niveus	193462	S	15767	6065	21832	0.00114
Streptomyces griseus	1911	S	5934	4676	10610	0.00056
Streptomyces anulatus	1892	S	4582	4670	9252	0.00048
Streptomyces microflavus	1919	S	2191	9668	11859	0.00062
Streptomyces globisporus	1908	S	1824	13560	15384	0.00081
Streptomyces asoensis	249586	S	15299	3942	19241	0.00101
Streptomyces calvus	67282	S	14727	4978	19705	0.00103
Streptomyces albus	1888	S	14720	6762	21482	0.00113
Streptomyces dengpaensis	2049881	S	14642	3470	18112	0.00095
Streptomyces lincolnensis	1915	S	14637	3681	18318	0.00096
Streptomyces griseochromogenes	68214	S	14399	3468	17867	0.00094
Streptomyces collinus	42684	S	13953	7504	21457	0.00112
Streptomyces seoulensis	73044	S	13411	4286	17697	0.00093
Streptomyces formicae	1616117	S	12840	3575	16415	0.00086
Streptomyces griseoviridis	45398	S	12499	3397	15896	0.00083
Streptomyces durmitorensis	319947	S	12483	2281	14764	0.00077
Streptomyces bingchenggensis	379067	S	12341	1920	14261	0.00075
Streptomyces cyaneochromogenes	2496836	S	11831	3048	14879	0.00078
Streptomyces davaonensis	348043	S	11633	2813	14446	0.00076
Streptomyces capitiformicae	2014920	S	11529	1626	13155	0.00069
Streptomyces ferrugineus	1413221	S	11169	3136	14305	0.00075
Streptomyces buecherae	2763006	S	10711	2176	12887	0.00068
Streptomyces tsukubensis	83656	S	10602	2086	12688	0.00066
Streptomyces actuosus	1885	S	10555	3806	14361	0.00075
Streptomyces broussonetiae	2686304	S	10197	2669	12866	0.00067
Streptomyces roseirectus	2768066	S	10156	2090	12246	0.00064
Streptomyces spectabilis	68270	S	10146	2908	13054	0.00068
Streptomyces fodineus	1904616	S	10118	3154	13272	0.00070
Streptomyces incarnatus	665007	S	10082	2673	12755	0.00067
Streptomyces phaeolivaceus	2653200	S	10071	2497	12568	0.00066
Streptomyces cattleya	29303	S	9643	2216	11859	0.00062
Streptomyces antibioticus	1890	S	9585	2915	12500	0.00065
Streptomyces roseochromogenus	285450	S	9526	2619	12145	0.00064
Streptomyces xanthii	2768069	S	9379	2341	11720	0.00061
Streptomyces viridosporus	67581	S	9135	3172	12307	0.00064
Streptomyces galilaeus	33899	S	9021	2590	11611	0.00061
Streptomyces nigra	1827580	S	8533	2847	11380	0.00060
Streptomyces vinaceus	1960	S	8419	2568	10987	0.00058
Streptomyces ambofaciens	1889	S	8419	4347	12766	0.00067
Streptomyces prasinus	67345	S	8416	2304	10720	0.00056
Streptomyces lunaelactis	1535768	S	8318	1446	9764	0.00051
Streptomyces dangxiongensis	1442032	S	8055	2406	10461	0.00055
Streptomyces rimosus	1927	S	8051	27281	35332	0.00185
Streptomyces pactum	68249	S	7839	2774	10613	0.00056
Streptomyces glaucescens	1907	S	7760	2854	10614	0.00056
Streptomyces vietnamensis	362257	S	7738	2222	9960	0.00052
Streptomyces chromofuscus	42881	S	7700	2549	10249	0.00054
Streptomyces pluripotens	1355015	S	7676	1479	9155	0.00048
Streptomyces paludis	2282738	S	7521	1344	8865	0.00046
Streptomyces tendae	1932	S	7430	2647	10077	0.00053
Streptomyces cyanogenus	80860	S	7393	2907	10300	0.00054
Streptomyces alboflavus	67267	S	7364	1746	9110	0.00048
Streptomyces aureoverticillatus	66871	S	7302	1691	8993	0.00047
Streptomyces parvulus	146923	S	7283	2793	10076	0.00053
Streptomyces albulus	68570	S	7228	1863	9091	0.00048
Streptomyces fagopyri	2662397	S	7183	2191	9374	0.00049
Streptomyces katrae	68223	S	7150	2257	9407	0.00049
Streptomyces atratus	1893	S	7142	1201	8343	0.00044
Streptomyces deccanensis	424188	S	7110	2752	9862	0.00052
Streptomyces liangshanensis	2717324	S	7100	1465	8565	0.00045
Streptomyces genisteinicus	2768068	S	7014	1803	8817	0.00046
Streptomyces xinghaiensis	1038928	S	7009	1699	8708	0.00046
Streptomyces olivoreticuli	68246	S	6976	1615	8591	0.00045
Streptomyces globosus	68209	S	6815	2046	8861	0.00046
Streptomyces griseocarneus	51201	S	6750	1926	8676	0.00045
Streptomyces ficellus	1977088	S	6695	1977	8672	0.00045
Streptomyces clavuligerus	1901	S	6656	1310	7966	0.00042
Streptomyces lavendulae	1914	S	6516	1923	8439	0.00044
Streptomyces rectiverticillatus	173860	S	6428	1683	8111	0.00042
Streptomyces luteoverticillatus	66425	S	6248	1687	7935	0.00042
Streptomyces coeruleorubidus	116188	S	6202	2744	8946	0.00047
Streptomyces hundungensis	1077946	S	6054	1580	7634	0.00040
Streptomyces exfoliatus	1905	S	6027	1743	7770	0.00041
Streptomyces peucetius	1950	S	5961	1356	7317	0.00038
Streptomyces subrutilus	36818	S	5911	1845	7756	0.00041
Streptomyces kanamyceticus	1967	S	5878	1810	7688	0.00040
Streptomyces gilvosporeus	553510	S	5874	1570	7444	0.00039
Streptomyces pratensis	1169025	S	5862	1222	7084	0.00037
Streptomyces hawaiiensis	67305	S	5819	2322	8141	0.00043
Streptomyces inhibens	2293571	S	5721	1507	7228	0.00038
Streptomyces finlayi	67296	S	5685	1079	6764	0.00035
Streptomyces tuirus	68278	S	5648	2547	8195	0.00043
Streptomyces harbinensis	1176198	S	5448	1192	6640	0.00035
Streptomyces pristinaespiralis	38300	S	5347	1914	7261	0.00038
Streptomyces angustmyceticus	285578	S	5294	1874	7168	0.00038
Streptomyces spongiicola	1690221	S	5218	1825	7043	0.00037
Streptomyces qinzhouensis	2599401	S	4980	1012	5992	0.00031
Streptomyces tirandamycinicus	2174846	S	4952	1399	6351	0.00033
Streptomyces nitrosporeus	28894	S	4947	1165	6112	0.00032
Streptomyces mobaraensis	35621	S	4798	193534	198332	0.01039
Streptomyces gardneri	66892	S	4640	1706	6346	0.00033
Streptomyces nojiriensis	66374	S	4458	1727	6185	0.00032
Streptomyces huasconensis	1854574	S	4447	1541	5988	0.00031
Streptomyces gobiensis	2875706	S	4298	646	4944	0.00026
Streptomyces rutgersensis	53451	S	4229	1777	6006	0.00031
Streptomyces leeuwenhoekii	1437453	S	3938	2562	6500	0.00034
Streptomyces cyaneogriseus	68192	S	3626	2613	6239	0.00033
Streptomyces olivaceus	47716	S	3004	11314	14318	0.00075
Streptomyces coelicolor	1902	S	1871	20687	22558	0.00118
Streptomyces auratus	114687	S	2693	1705	4398	0.00023
Streptomyces antimycoticus	68175	S	2674	2777	5451	0.00029
Streptomyces decoyicus	249567	S	2581	1359	3940	0.00021
Streptomyces platensis	58346	S	2506	1820	4326	0.00023
Streptomyces lydicamycinicus	1546107	S	2299	1313	3612	0.00019
Streptomyces fungicidicus	68203	S	2241	6587	8828	0.00046
Streptomyces xiamenensis	408015	S	1716	1440	3156	0.00017
Streptomyces griseofuscus	146922	S	1710	7995	9705	0.00051
Streptomyces alfalfae	1642299	S	1400	8301	9701	0.00051
Streptomyces lividans	1916	S	1309	8607	9916	0.00052
Streptomyces filamentosus	67294	S	1255	1549	2804	0.00015
Streptomyces mirabilis	68239	S	1197	7610	8807	0.00046
Streptomyces cavourensis	67258	S	1074	1931	3005	0.00016
Streptomyces californicus	67351	S	1021	3401	4422	0.00023
Kitasatospora sp. MMS16-BH015	2018025	S	11444	3071	14515	0.00076
Kitasatospora sp. NA04385	2742135	S	9839	4633	14472	0.00076
Kitasatospora setae	2066	S	9335	4206	13541	0.00071
Kitasatospora aureofaciens	1894	S	8550	2847	11397	0.00060
Kitasatospora albolonga	68173	S	2266	1487	3753	0.00020
Yinghuangia sp. ASG 101	2896848	S	25732	3343	29075	0.00152
Streptacidiphilus sp. P02-A3a	2704468	S	8798	2193	10991	0.00058
Streptacidiphilus sp. PB12-B1b	2705012	S	7549	2418	9967	0.00052
Streptacidiphilus bronchialis	2126346	S	6735	1732	8467	0.00044
Microbacterium sp. No. 7	1714373	S	5526	2204	7730	0.00040
Microbacterium sp. 4R-513	2567934	S	5035	930	5965	0.00031
Microbacterium sp. 10M-3C3	2483401	S	3986	2339	6325	0.00033
Microbacterium sp. JZ31	1906274	S	3956	1038	4994	0.00026
Microbacterium sp. SSW1-51	2851650	S	3661	1445	5106	0.00027
Microbacterium sp. SSW1-36	2851648	S	3657	1119	4776	0.00025
Microbacterium sp. BH-3-3-3	1906742	S	3255	773	4028	0.00021
Microbacterium sp. YJN-G	2763257	S	3251	1288	4539	0.00024
Microbacterium sp. XT11	367477	S	3183	771	3954	0.00021
Microbacterium sp. Y-01	2048898	S	3072	2007	5079	0.00027
Microbacterium sp. ABRD_28	2268461	S	2865	386	3251	0.00017
Microbacterium sp. H1-D42	2925844	S	2765	524	3289	0.00017
Microbacterium sp. CBA3102	2603598	S	2576	1166	3742	0.00020
Microbacterium sp. A18JL241	2782166	S	2543	723	3266	0.00017
Microbacterium sp. NIBRBAC000506063	2734618	S	2489	925	3414	0.00018
Microbacterium sp. LKL04	912630	S	2486	590	3076	0.00016
Microbacterium sp. PM5	2014534	S	2486	471	2957	0.00015
Microbacterium sp. cx-55	2875948	S	2486	354	2840	0.00015
Microbacterium sp. TPU 3598	1938334	S	2467	1269	3736	0.00020
Microbacterium sp. 1S1	2606451	S	2178	2154	4332	0.00023
Microbacterium sp. Nx66	2766784	S	1763	2588	4351	0.00023
Microbacterium sp. RG1	2489212	S	1052	982	2034	0.00011
Microbacterium foliorum	104336	S	9368	1833	11201	0.00059
Microbacterium hominis	162426	S	5435	18508	23943	0.00125
Microbacterium oleivorans	273677	S	5150	852	6002	0.00031
Microbacterium cremeum	2782169	S	4896	865	5761	0.00030
Microbacterium atlanticum	2782168	S	4287	788	5075	0.00027
Microbacterium lemovicicum	1072463	S	3886	730	4616	0.00024
Microbacterium resistens	156977	S	3784	577	4361	0.00023
Microbacterium sediminis	904291	S	3416	1293	4709	0.00025
Microbacterium oryzae	743009	S	3290	793	4083	0.00021
Microbacterium testaceum	2033	S	3266	504	3770	0.00020
Microbacterium pygmaeum	370764	S	3261	336	3597	0.00019
Microbacterium hydrocarbonoxydans	273678	S	3230	542	3772	0.00020
Microbacterium aurum	36805	S	2977	800	3777	0.00020
Microbacterium oxydans	82380	S	2975	2610	5585	0.00029
Microbacterium wangchenii	2541726	S	2889	597	3486	0.00018
Microbacterium luteum	2782167	S	2787	975	3762	0.00020
Microbacterium protaetiae	2509458	S	2731	491	3222	0.00017
Microbacterium caowuchunii	2614638	S	2718	423	3141	0.00016
Microbacterium lushaniae	2614639	S	2642	558	3200	0.00017
Microbacterium esteraromaticum	57043	S	2628	515	3143	0.00016
Microbacterium chocolatum	84292	S	2568	475	3043	0.00016
Microbacterium schleiferi	69362	S	1783	506	2289	0.00012
Microbacterium fandaimingii	2708079	S	1209	85	1294	0.00007
Microbacterium binotii	462710	S	1100	966	2066	0.00011
Agromyces sp. H17E-10	2932244	S	6607	1825	8432	0.00044
Agromyces sp. LHK192	2498704	S	4939	1199	6138	0.00032
Agromyces sp. CFWR-12	2929802	S	3686	1853	5539	0.00029
Agromyces flavus	589382	S	5113	1359	6472	0.00034
Agromyces soli	659012	S	5063	1551	6614	0.00035
Agromyces aureus	453304	S	4713	1126	5839	0.00031
Agromyces protaetiae	2509455	S	3898	942	4840	0.00025
Agromyces marinus	1389020	S	3709	1135	4844	0.00025
Agromyces archimandritae	2781962	S	3674	884	4558	0.00024
Agromyces intestinalis	2592652	S	3516	1690	5206	0.00027
Agromyces badenianii	2080742	S	3105	862	3967	0.00021
Agromyces laixinhei	2585717	S	2964	576	3540	0.00019
Curtobacterium sp. BH-2-1-1	1905847	S	6018	2146	8164	0.00043
Curtobacterium sp. L6-1	2841594	S	3137	978	4115	0.00022
Curtobacterium sp. YC1	2795488	S	2564	1213	3777	0.00020
Curtobacterium sp. MR_MD2014	1561023	S	2467	1508	3975	0.00021
Curtobacterium sp. TC1	2862880	S	2156	1615	3771	0.00020
Curtobacterium sp. 24E2	2804758	S	2155	1715	3870	0.00020
Curtobacterium sp. SGAir0471	2070337	S	1620	2418	4038	0.00021
Curtobacterium sp. TXMA1	2876939	S	1556	2416	3972	0.00021
Curtobacterium flaccumfaciens	2035	S	5022	1992	7014	0.00037
Curtobacterium luteum	33881	S	4644	1406	6050	0.00032
Leifsonia sp. 21MFCrub1.1	1798223	S	7288	8499	15787	0.00083
Leifsonia sp. ZF2019	2781978	S	6326	1566	7892	0.00041
Leifsonia sp. PS1209	2724914	S	5550	1360	6910	0.00036
Leifsonia shinshuensis	150026	S	10939	2711	13650	0.00072
Leifsonia xyli	1575	S	3384	400	3784	0.00020
Rathayibacter sp. VKM Ac-2759	2609252	S	4017	1339	5356	0.00028
Rathayibacter sp. VKM Ac-2760	2609253	S	3629	2035	5664	0.00030
Rathayibacter sp. VKM Ac-2804	2609257	S	2639	2134	4773	0.00025
Rathayibacter sp. VKM Ac-2801	2609255	S	1645	3015	4660	0.00024
Rathayibacter festucae	110937	S	3973	3931	7904	0.00041
Rathayibacter tanaceti	1671680	S	2328	526	2854	0.00015
Rathayibacter tritici	33888	S	1469	415	1884	0.00010
Rathayibacter iranicus	59737	S	1445	171	1616	0.00008
Rathayibacter rathayi	33887	S	1321	328	1649	0.00009
Clavibacter michiganensis	28447	S	17296	13792	31088	0.00163
Clavibacter zhangzhiyongii	2768071	S	2284	1004	3288	0.00017
Clavibacter sp. A6099	2860285	S	1280	798	2078	0.00011
Leucobacter sp. H25R-14	2932245	S	2746	2264	5010	0.00026
Leucobacter sp. NB 10	2873270	S	2528	1246	3774	0.00020
Leucobacter sp. Psy1	2875729	S	1931	532	2463	0.00013
Leucobacter sp. CX169	2813744	S	1621	607	2228	0.00012
Leucobacter muris	1935379	S	3101	1008	4109	0.00022
Leucobacter triazinivorans	1784719	S	2702	1363	4065	0.00021
Agrococcus sp. SGAir0287	2070347	S	4359	1145	5504	0.00029
Agrococcus sp. SCSIO52902	2933290	S	3876	1638	5514	0.00029
Agrococcus sp. Marseille-Q4369	2810513	S	3703	1130	4833	0.00025
Agrococcus jejuensis	399736	S	4851	1325	6176	0.00032
Agrococcus carbonis	684552	S	4115	1627	5742	0.00030
Protaetiibacter sp. SSC-01	2759943	S	3878	1263	5141	0.00027
Protaetiibacter intestinalis	2419774	S	3826	1214	5040	0.00026
Protaetiibacter larvae	2592654	S	2727	763	3490	0.00018
Salinibacterium sp. ZJ450	2708338	S	2569	359	2928	0.00015
Salinibacterium sp. ZJ70	2708084	S	2351	541	2892	0.00015
Salinibacterium sp. dk2585	2603292	S	1708	272	1980	0.00010
Cryobacterium sp. LW097	1978566	S	2161	420	2581	0.00014
Cryobacterium sp. PAMC25264	2861288	S	1180	684	1864	0.00010
Cryobacterium soli	2220095	S	1788	870	2658	0.00014
Cryobacterium arcticum	670052	S	1533	1095	2628	0.00014
Frondihabitans sp. PAMC 28766	1795630	S	3938	451	4389	0.00023
Frondihabitans sp. 762G35	1446794	S	3289	601	3890	0.00020
Plantibacter sp. M259	2583822	S	1261	1056	2317	0.00012
Plantibacter sp. PA-3-X8	2480625	S	1201	1037	2238	0.00012
Plantibacter flavus	150123	S	1380	1049	2429	0.00013
Microterricola viridarii	412690	S	6107	1308	7415	0.00039
Microcella flavibacter	1804990	S	3446	1413	4859	0.00025
Microcella alkaliphila	279828	S	2062	311	2373	0.00012
Cnuibacter physcomitrellae	1619308	S	4690	883	5573	0.00029
Herbiconiux sp. SALV-R1	2735133	S	4617	804	5421	0.00028
Gryllotalpicola protaetiae	2419771	S	4344	725	5069	0.00027
Frigoribacterium sp. NBH87	2596916	S	4173	1066	5239	0.00027
Mycetocola sp. JXN-3	2116510	S	1437	179	1616	0.00008
Mycetocola zhujimingii	2079792	S	1304	134	1438	0.00008
Mycetocola spongiae	2859226	S	1161	127	1288	0.00007
Subtercola sp. AK-R2A1-2	2895559	S	2309	182	2491	0.00013
Subtercola sp. PAMC28395	2846775	S	1375	115	1490	0.00008
Humibacter sp. WJ7-1	2599293	S	3541	673	4214	0.00022
Amnibacterium sp. L3-i23	2905871	S	3147	653	3800	0.00020
Gulosibacter sediminis	1729695	S	2469	595	3064	0.00016
Marisediminicola antarctica	674079	S	2415	259	2674	0.00014
Diaminobutyricimonas sp. LJ205	2683590	S	2052	332	2384	0.00012
Glaciihabitans sp. INWT7	2596912	S	1943	134	2077	0.00011
Agreia sp. COWG	2773266	S	1842	194	2036	0.00011
Arthrobacter sp. FW305-BF8	2879617	S	37204	8164	45368	0.00238
Arthrobacter sp. NicSoilC5	2831000	S	30012	11407	41419	0.00217
Arthrobacter sp. QXT-31	1357915	S	29640	6687	36327	0.00190
Arthrobacter sp. NtRootA1	2830983	S	12761	2930	15691	0.00082
Arthrobacter sp. PM3	2017685	S	5669	667	6336	0.00033
Arthrobacter sp. NicSoilB8	2830998	S	5353	1110	6463	0.00034
Arthrobacter sp. NicSoilB11	2830999	S	4939	14043	18982	0.00099
Arthrobacter sp. 24S4-2	2575374	S	4910	876	5786	0.00030
Arthrobacter sp. UKPF54-2	2600159	S	4903	1650	6553	0.00034
Arthrobacter sp. KBS0702	2578107	S	4771	1519	6290	0.00033
Arthrobacter sp. StoSoilB19	2830994	S	4771	15553	20324	0.00106
Arthrobacter sp. FB24	290399	S	4335	1015	5350	0.00028
Arthrobacter sp. PGP41	2079227	S	4328	1069	5397	0.00028
Arthrobacter sp. PAMC25564	2565366	S	4326	946	5272	0.00028
Arthrobacter sp. NicSoilB4	2830997	S	4200	1056	5256	0.00028
Arthrobacter sp. U41	1849032	S	4146	927	5073	0.00027
Arthrobacter sp. FW306-2-2C-D06B	2879618	S	3980	632	4612	0.00024
Arthrobacter sp. QL17	2895818	S	3166	613	3779	0.00020
Arthrobacter sp. PAMC25284	2861279	S	3075	652	3727	0.00020
Arthrobacter sp. FW306-06-A	2879621	S	2989	7539	10528	0.00055
Arthrobacter sp. ERGS1:01	1704044	S	2539	414	2953	0.00015
Arthrobacter sp. StoSoilB5	2830992	S	2126	469	2595	0.00014
Arthrobacter sp. FW306-07-I	2879622	S	2003	8045	10048	0.00053
Arthrobacter sp. FW306-05-C	2879620	S	1802	6803	8605	0.00045
Arthrobacter sp. StoSoilB20	2830995	S	1787	372	2159	0.00011
Arthrobacter sp. Helios	2828862	S	1700	235	1935	0.00010
Arthrobacter sp. zg-Y462	2886936	S	1419	246	1665	0.00009
Arthrobacter sp. YN	2020486	S	1347	409	1756	0.00009
Arthrobacter sp. D5-1	1477518	S	1346	679	2025	0.00011
Arthrobacter sp. PAMC 25486	1494608	S	1321	186	1507	0.00008
Arthrobacter sp. zg-Y809	2886940	S	1234	382	1616	0.00008
Arthrobacter agilis	37921	S	4789	574	5363	0.00028
Arthrobacter crystallopoietes	37928	S	3842	574	4416	0.00023
Arthrobacter woluwensis	156980	S	2630	489	3119	0.00016
Arthrobacter sulfonylureivorans	2486855	S	2371	309	2680	0.00014
Arthrobacter dokdonellae	2211210	S	2273	325	2598	0.00014
Arthrobacter alpinus	656366	S	1633	2228	3861	0.00020
Arthrobacter jiangjiafuii	2817475	S	1528	354	1882	0.00010
Arthrobacter sunyaminii	2816859	S	1064	305	1369	0.00007
Pseudarthrobacter sp. L1SW	2851598	S	3174	928	4102	0.00021
Pseudarthrobacter sp. BIM B-2242	2772401	S	3137	610	3747	0.00020
Pseudarthrobacter sp. NIBRBAC000502770	2590785	S	2828	7121	9949	0.00052
Pseudarthrobacter sp. NIBRBAC000502771	2590774	S	2735	7753	10488	0.00055
Pseudarthrobacter sp. NBSH8	2596911	S	1611	523	2134	0.00011
Pseudarthrobacter sp. NIBRBAC000502772	2590775	S	1471	995	2466	0.00013
Pseudarthrobacter sp. SSS035	2931399	S	1293	1102	2395	0.00013
Pseudarthrobacter chlorophenolicus	85085	S	3406	1025	4431	0.00023
Pseudarthrobacter phenanthrenivorans	361575	S	3314	1161	4475	0.00023
Pseudarthrobacter equi	728066	S	3240	1046	4286	0.00022
Pseudarthrobacter psychrotolerans	2697569	S	1982	686	2668	0.00014
Pseudarthrobacter sulfonivorans	121292	S	1139	1183	2322	0.00012
Sinomonas atrocyanea	37927	S	22407	5666	28073	0.00147
Sinomonas sp. R1AF57	2020377	S	6161	1097	7258	0.00038
Kocuria rosea	1275	S	4244	1184	5428	0.00028
Kocuria flava	446860	S	3888	1597	5485	0.00029
Kocuria turfanensis	388357	S	3711	1158	4869	0.00026
Kocuria palustris	71999	S	2187	681	2868	0.00015
Kocuria rhizophila	72000	S	1835	3213	5048	0.00026
Kocuria varians	1272	S	1520	931	2451	0.00013
Micrococcus luteus	1270	S	5218	7544	12762	0.00067
Micrococcus sp. KD337-16	2856555	S	2184	1057	3241	0.00017
Paenarthrobacter ureafaciens	37931	S	2412	5089	7501	0.00039
Paenarthrobacter aurescens	43663	S	1786	947	2733	0.00014
Glutamicibacter protophormiae	37930	S	1440	1777	3217	0.00017
Glutamicibacter creatinolyticus	162496	S	1412	457	1869	0.00010
Rothia kristinae	37923	S	2540	1217	3757	0.00020
Citricoccus sp. SGAir0253	2567881	S	3575	756	4331	0.00023
Nesterenkonia sp. NBAIMH1	2600320	S	1224	64	1288	0.00007
Cellulomonas sp. H30R-01	2704467	S	7470	2606	10076	0.00053
Cellulomonas sp. Y8	2591145	S	7326	2788	10114	0.00053
Cellulomonas sp. C5510	2871170	S	5643	2013	7656	0.00040
Cellulomonas sp. zg-ZUI188	2819978	S	5625	1383	7008	0.00037
Cellulomonas sp. JZ18	2654191	S	5532	2104	7636	0.00040
Cellulomonas sp. zg-ZUI222	2816956	S	5098	1713	6811	0.00036
Cellulomonas sp. zg-ZUI157	2819979	S	4915	1523	6438	0.00034
Cellulomonas sp. EW123	2608402	S	4394	2379	6773	0.00035
Cellulomonas sp. PSBB021	2003551	S	4187	3041	7228	0.00038
Cellulomonas fimi	1708	S	6424	5044	11468	0.00060
Cellulomonas iranensis	76862	S	5414	2242	7656	0.00040
Cellulomonas shaoxiangyii	2566013	S	5388	1976	7364	0.00039
Cellulomonas flavigena	1711	S	4941	1665	6606	0.00035
Cellulomonas gilvus	11	S	4482	1735	6217	0.00033
Cellulomonas taurus	2729175	S	3441	958	4399	0.00023
Actinotalea sp. JY-7876	2758442	S	5646	1774	7420	0.00039
Oerskovia sp. KBS0722	1179673	S	4452	1245	5697	0.00030
Pseudactinotalea sp. HY158	2654547	S	3817	478	4295	0.00023
Paraoerskovia marina	545619	S	3033	685	3718	0.00019
Janibacter melonis	262209	S	7584	2285	9869	0.00052
Janibacter limosus	53458	S	5048	1194	6242	0.00033
Janibacter indicus	857417	S	2668	3927	6595	0.00035
Janibacter sp. YB324	2761047	S	1466	2970	4436	0.00023
Phycicoccus sp. HDW14	2714941	S	11481	3472	14953	0.00078
Phycicoccus endophyticus	1690220	S	8167	2206	10373	0.00054
Pedococcus dokdonensis	443156	S	17937	4918	22855	0.00120
Intrasporangium calvum	53358	S	17612	3933	21545	0.00113
Tetrasphaera sp. HKS02	1813880	S	12918	3137	16055	0.00084
Arsenicicoccus sp. oral taxon 190	1658671	S	6624	2213	8837	0.00046
Cellulosimicrobium cellulans	1710	S	11585	13871	25456	0.00133
Cellulosimicrobium sp. BI34T	2587808	S	4385	2448	6833	0.00036
Xylanimonas protaetiae	2509457	S	4837	1875	6712	0.00035
Xylanimonas cellulosilytica	186189	S	4203	1313	5516	0.00029
Xylanimonas allomyrinae	2509459	S	4174	1153	5327	0.00028
Isoptericola variabilis	139208	S	5497	2521	8018	0.00042
Isoptericola dokdonensis	372663	S	5017	1695	6712	0.00035
Ornithinimicrobium avium	2283195	S	6114	1413	7527	0.00039
Ornithinimicrobium sp. HY006	2508882	S	4228	1306	5534	0.00029
Ornithinimicrobium flavum	1288636	S	4693	1362	6055	0.00032
Ornithinimicrobium ciconiae	2594265	S	3673	493	4166	0.00022
Ornithinimicrobium pratense	2593973	S	3032	792	3824	0.00020
Serinicoccus chungangensis	767452	S	4504	1337	5841	0.00031
Serinicoccus hydrothermalis	1758689	S	4142	1678	5820	0.00030
Serinicoccus profundi	1078471	S	4024	1253	5277	0.00028
Serinicoccus marinus	247333	S	3515	1493	5008	0.00026
Brachybacterium sp. SGAir0954	2571029	S	4013	952	4965	0.00026
Brachybacterium sp. CBA3105	2887346	S	3971	777	4748	0.00025
Brachybacterium sp. P6-10-X1	1903186	S	3258	484	3742	0.00020
Brachybacterium ginsengisoli	1331682	S	3359	832	4191	0.00022
Brachybacterium saurashtrense	556288	S	3262	788	4050	0.00021
Brachybacterium faecium	43669	S	3139	812	3951	0.00021
Brachybacterium vulturis	2017484	S	2288	716	3004	0.00016
Brachybacterium avium	2017485	S	2067	645	2712	0.00014
Brevibacterium sp. CS2	2575923	S	3428	1197	4625	0.00024
Brevibacterium sp. SMBL_HHYL_HB1	2777556	S	1597	438	2035	0.00011
Brevibacterium casei	33889	S	3755	3854	7609	0.00040
Brevibacterium linens	1703	S	1850	1911	3761	0.00020
Brevibacterium luteolum	199591	S	1848	646	2494	0.00013
Brevibacterium atlanticum	2697563	S	1217	389	1606	0.00008
Brevibacterium aurantiacum	273384	S	1216	1050	2266	0.00012
Brevibacterium oceani	358099	S	1190	416	1606	0.00008
Brevibacterium sandarakinum	629680	S	1068	296	1364	0.00007
Dermacoccus nishinomiyaensis	1274	S	4273	1625	5898	0.00031
Dermacoccus sp. PAMC28757	2762331	S	3061	997	4058	0.00021
Luteipulveratus mongoliensis	571913	S	6088	738	6826	0.00036
Allobranchiibius sp. GilTou73	2904523	S	5144	978	6122	0.00032
Yimella sp. cx-51	2770551	S	2766	479	3245	0.00017
Georgenia yuyongxinii	2589797	S	5621	1193	6814	0.00036
Georgenia sp. TF02-10	2917725	S	5525	1743	7268	0.00038
Georgenia wutianyii	2585135	S	5015	1504	6519	0.00034
Georgenia faecalis	2483799	S	4672	1117	5789	0.00030
Haloactinobacterium kanbiaonis	2675754	S	6000	749	6749	0.00035
Ruania sp. LR1S40	2897774	S	3075	560	3635	0.00019
Ruania sp. M4N3S171	2897773	S	1889	236	2125	0.00011
Ruania zhangjianzhongii	2603206	S	3256	278	3534	0.00019
Ruania alkalisoli	2779775	S	2307	344	2651	0.00014
Pengzhenrongella sicca	2819238	S	6737	1625	8362	0.00044
Luteimicrobium xylanilyticum	1133546	S	5927	1579	7506	0.00039
Beutenbergia cavernae	84757	S	6932	990	7922	0.00041
Miniimonas sp. S16	2171623	S	4848	2188	7036	0.00037
Sanguibacter keddieii	60920	S	4646	1194	5840	0.00031
Sanguibacter sp. HDW7	2714931	S	3966	1070	5036	0.00026
Gephyromycinifex aptenodytis	2716227	S	1944	203	2147	0.00011
Austwickia chelonae	100225	S	1414	98	1512	0.00008
Kytococcus sedentarius	1276	S	3653	1619	5272	0.00028
Demequina sp. TMPB413	2881056	S	1176	78	1254	0.00007
Mycolicibacterium litorale	758802	S	8113	1945	10058	0.00053
Mycolicibacterium septicum	98668	S	7561	4873	12434	0.00065
Mycolicibacterium sp. YH-1	2908837	S	4144	3609	7753	0.00041
Mycolicibacterium phocaicum	319706	S	7262	3455	10717	0.00056
Mycolicibacterium smegmatis	1772	S	6204	3654	9858	0.00052
Mycolicibacterium fluoranthenivorans	258505	S	5921	640	6561	0.00034
Mycolicibacterium sediminis	1286180	S	5212	782	5994	0.00031
Mycolicibacterium madagascariense	212765	S	5207	642	5849	0.00031
Mycolicibacterium arabiense	1286181	S	5204	653	5857	0.00031
Mycolicibacterium fortuitum	1766	S	5182	1722	6904	0.00036
Mycolicibacterium rutilum	370526	S	5124	1327	6451	0.00034
Mycolicibacterium chubuense	1800	S	4878	963	5841	0.00031
Mycolicibacterium mageritense	53462	S	4872	727	5599	0.00029
Mycolicibacterium phlei	1771	S	4777	1365	6142	0.00032
Mycolicibacterium psychrotolerans	216929	S	4776	923	5699	0.00030
Mycolicibacterium neoaurum	1795	S	4757	1058	5815	0.00030
Mycolicibacterium boenickei	146017	S	4633	5963	10596	0.00056
Mycolicibacterium vaccae	1810	S	4514	752	5266	0.00028
Mycolicibacterium parafortuitum	39692	S	4494	745	5239	0.00027
Mycolicibacterium mucogenicum	56689	S	4422	1615	6037	0.00032
Mycolicibacterium hassiacum	46351	S	4371	1005	5376	0.00028
Mycolicibacterium chitae	1792	S	4283	854	5137	0.00027
Mycolicibacterium rhodesiae	36814	S	4241	611	4852	0.00025
Mycolicibacterium moriokaense	39691	S	4121	424	4545	0.00024
Mycolicibacterium helvum	1534349	S	4013	410	4423	0.00023
Mycolicibacterium aichiense	1799	S	3929	586	4515	0.00024
Mycolicibacterium monacense	85693	S	3831	1117	4948	0.00026
Mycolicibacterium tokaiense	39695	S	3815	508	4323	0.00023
Mycolicibacterium poriferae	39694	S	3773	693	4466	0.00023
Mycolicibacterium aurum	1791	S	3722	403	4125	0.00022
Mycolicibacterium duvalii	39688	S	3718	614	4332	0.00023
Mycolicibacterium pulveris	36813	S	3717	529	4246	0.00022
Mycolicibacterium baixiangningiae	2761578	S	3695	504	4199	0.00022
Mycolicibacterium gadium	1794	S	3689	440	4129	0.00022
Mycolicibacterium thermoresistibile	1797	S	3646	678	4324	0.00023
Mycolicibacterium gilvum	1804	S	3633	1231	4864	0.00025
Mycolicibacterium celeriflavum	1249101	S	3381	581	3962	0.00021
Mycolicibacterium fallax	1793	S	3376	1141	4517	0.00024
Mycolicibacterium confluentis	28047	S	3367	421	3788	0.00020
Mycolicibacterium insubricum	444597	S	3122	757	3879	0.00020
Mycolicibacterium anyangense	1431246	S	2998	411	3409	0.00018
Mycolicibacterium mengxianglii	2736649	S	2928	259	3187	0.00017
Mycolicibacterium sarraceniae	1534348	S	2812	311	3123	0.00016
Mycolicibacterium austroafricanum	39687	S	2704	10232	12936	0.00068
Mycolicibacterium alvei	67081	S	2647	668	3315	0.00017
Mycobacterium doricum	126673	S	2216	440	2656	0.00014
Mycolicibacterium farcinogenes	1802	S	1315	4482	5797	0.00030
Mycolicibacterium nivoides	2487344	S	1197	5493	6690	0.00035
Mycobacterium sp. JS623	212767	S	17494	1283	18777	0.00098
Mycobacterium sp. EPa45	1545728	S	5197	855	6052	0.00032
Mycobacterium sp. IDR2000157661	2867005	S	3641	613	4254	0.00022
Mycobacterium sp. DL592	2675524	S	3248	475	3723	0.00020
Mycobacterium sp. YC-RL4	1682113	S	3174	1031	4205	0.00022
Mycobacterium sp. MS1601	1936029	S	3030	379	3409	0.00018
Mycobacterium sp. DL440	2675523	S	2926	626	3552	0.00019
Mycobacterium sp. TY59	2775496	S	2124	377	2501	0.00013
Mycobacterium sp. WY10	1920667	S	1848	8786	10634	0.00056
Mycobacterium saskatchewanense	220927	S	3689	645	4334	0.00023
Mycobacterium parmense	185642	S	3483	606	4089	0.00021
Mycobacterium kubicae	120959	S	3043	491	3534	0.00019
Mycobacterium shigaense	722731	S	2695	337	3032	0.00016
Mycobacterium simiae	1784	S	2632	194	2826	0.00015
Mycobacterium florentinum	292462	S	2524	509	3033	0.00016
Mycobacterium lentiflavum	141349	S	2355	514	2869	0.00015
Mycobacterium heidelbergense	53376	S	2321	506	2827	0.00015
Mycobacterium stomatepiae	470076	S	2275	412	2687	0.00014
Mycobacterium avium	1764	S	5462	3897	9359	0.00049
Mycobacterium intracellulare	1767	S	2949	22170	25119	0.00132
Mycobacterium colombiense	339268	S	2657	411	3068	0.00016
Mycobacterium marseillense	701042	S	2570	572	3142	0.00016
Mycobacterium mantenii	560555	S	2424	266	2690	0.00014
Mycobacterium rufum	318424	S	7168	1864	9032	0.00047
Mycobacterium crocinum	388459	S	6970	4074	11044	0.00058
Mycobacterium grossiae	1552759	S	5421	1378	6799	0.00036
Mycobacterium dioxanotrophicus	482462	S	4412	962	5374	0.00028
Mycobacterium conspicuum	44010	S	4308	465	4773	0.00025
Mycobacterium frederiksbergense	117567	S	3805	1074	4879	0.00026
Mycobacterium diernhoferi	1801	S	3696	621	4317	0.00023
Mycobacterium holsaticum	152142	S	3677	496	4173	0.00022
Mycobacterium goodii	134601	S	3419	1160	4579	0.00024
Mycobacterium branderi	43348	S	3308	349	3657	0.00019
Mycobacterium paragordonae	1389713	S	3264	361	3625	0.00019
Mycobacterium canettii	78331	S	1069	2034	3103	0.00016
Mycobacterium cookii	1775	S	2861	236	3097	0.00016
Mycobacterium gordonae	1778	S	2805	210	3015	0.00016
Mycobacterium paraterrae	577492	S	2712	260	2972	0.00016
Mycobacterium koreense	1069220	S	2530	650	3180	0.00017
Mycobacterium kansasii	1768	S	2374	13234	15608	0.00082
Mycobacterium riyadhense	486698	S	2332	83	2415	0.00013
Mycobacterium paraseoulense	590652	S	2290	451	2741	0.00014
Mycobacterium vicinigordonae	1719132	S	2260	102	2362	0.00012
Mycobacterium noviomagense	459858	S	2220	146	2366	0.00012
Mycobacterium heckeshornense	110505	S	2192	152	2344	0.00012
Mycobacterium lacus	169765	S	2143	134	2277	0.00012
Mycobacterium seoulense	386911	S	2036	462	2498	0.00013
Mycobacterium shinjukuense	398694	S	2015	172	2187	0.00011
Mycobacterium malmoense	1780	S	2014	287	2301	0.00012
Mycobacterium virginiense	1795032	S	1970	485	2455	0.00013
Mycobacterium ostraviense	2738409	S	1960	196	2156	0.00011
Mycobacterium xenopi	1789	S	1805	198	2003	0.00010
Mycobacterium basiliense	2094119	S	1737	51	1788	0.00009
Mycobacterium spongiae	886343	S	1724	39	1763	0.00009
Mycobacterium haemophilum	29311	S	1158	48	1206	0.00006
Mycolicibacter sp. MYC340	2855503	S	1949	754	2703	0.00014
Mycolicibacter sp. MYC098	2872309	S	1652	671	2323	0.00012
Mycolicibacter sp. MYC017	2875777	S	1132	2352	3484	0.00018
Mycolicibacter terrae	1788	S	2214	670	2884	0.00015
Mycolicibacter hiberniae	29314	S	2076	405	2481	0.00013
Mycolicibacter minnesotensis	1118379	S	1535	246	1781	0.00009
Mycobacteroides abscessus	36809	S	3974	3292	7266	0.00038
Mycobacteroides chelonae	1774	S	3113	1755	4868	0.00025
Mycobacteroides saopaulense	1578165	S	1732	193	1925	0.00010
Mycobacteroides salmoniphilum	404941	S	1562	135	1697	0.00009
Mycobacteroides immunogenum	83262	S	1505	280	1785	0.00009
Mycolicibacillus parakoreensis	1069221	S	2914	764	3678	0.00019
Hoyosella subflava	639313	S	1285	58	1343	0.00007
Nocardia asteroides	1824	S	31361	10144	41505	0.00217
Nocardia nova	37330	S	23108	2916	26024	0.00136
Nocardia brasiliensis	37326	S	20734	5357	26091	0.00137
Nocardia cyriacigeorgica	135487	S	14419	5986	20405	0.00107
Nocardia terpenica	455432	S	13232	2123	15355	0.00080
Nocardia farcinica	37329	S	9576	5346	14922	0.00078
Nocardia arthritidis	228602	S	9557	1102	10659	0.00056
Nocardia wallacei	480035	S	8742	2513	11255	0.00059
Nocardia gipuzkoensis	2749991	S	8178	3197	11375	0.00060
Nocardia sp. CS682	1047172	S	8036	1938	9974	0.00052
Nocardia iowensis	204891	S	7811	1704	9515	0.00050
Nocardia yamanashiensis	209247	S	6521	1238	7759	0.00041
Nocardia tengchongensis	2055889	S	6518	1601	8119	0.00043
Nocardia huaxiensis	2755382	S	6422	1198	7620	0.00040
Nocardia otitidiscaviarum	1823	S	6154	1117	7271	0.00038
Nocardia yunnanensis	2382165	S	6076	1513	7589	0.00040
Nocardia seriolae	37332	S	5954	1603	7557	0.00040
Nocardia mangyaensis	2213200	S	5550	1407	6957	0.00036
Rhodococcus sp. X156	2499145	S	5373	1488	6861	0.00036
Rhodococcus sp. MTM3W5.2	1805827	S	4839	985	5824	0.00031
Rhodococcus sp. SGAir0479	2567884	S	4052	1052	5104	0.00027
Rhodococcus sp. W8901	2742603	S	3980	937	4917	0.00026
Rhodococcus sp. PBTS 1	1653478	S	3649	782	4431	0.00023
Rhodococcus sp. ABRD24	2507582	S	2537	398	2935	0.00015
Rhodococcus sp. R79	2811421	S	2498	2536	5034	0.00026
Rhodococcus sp. USK10	2789739	S	2052	2184	4236	0.00022
Rhodococcus sp. B7740	1564114	S	1785	225	2010	0.00011
Rhodococcus sp. P1Y	1302308	S	1757	141	1898	0.00010
Rhodococcus sp. WMMA185	679318	S	1533	167	1700	0.00009
Rhodococcus sp. USK13	2806442	S	1234	1585	2819	0.00015
Rhodococcus sp. WAY2	2663121	S	1229	1960	3189	0.00017
Rhodococcus opacus	37919	S	12357	15744	28101	0.00147
Rhodococcus equi	43767	S	6232	1991	8223	0.00043
Rhodococcus fascians	1828	S	5341	1038	6379	0.00033
Rhodococcus rhodochrous	1829	S	3487	2211	5698	0.00030
Rhodococcus triatomae	300028	S	3314	851	4165	0.00022
Rhodococcus qingshengii	334542	S	1977	13710	15687	0.00082
Rhodococcus koreensis	99653	S	3117	1075	4192	0.00022
Rhodococcus coprophilus	38310	S	2484	364	2848	0.00015
Rhodococcus jostii	132919	S	2217	1090	3307	0.00017
Rhodococcus pyridinivorans	103816	S	1885	8563	10448	0.00055
Rhodococcus ruber	1830	S	1705	6582	8287	0.00043
Rhodococcus globerulus	33008	S	1620	166	1786	0.00009
Corynebacterium cyclohexanicum	322009	S	5870	1702	7572	0.00040
Corynebacterium frankenforstense	1230998	S	2701	917	3618	0.00019
Corynebacterium xerosis	1725	S	2566	1955	4521	0.00024
Corynebacterium sphenisci	191493	S	2515	732	3247	0.00017
Corynebacterium bovis	36808	S	2260	556	2816	0.00015
Corynebacterium halotolerans	225326	S	1962	656	2618	0.00014
Corynebacterium nuruki	1032851	S	1822	530	2352	0.00012
Corynebacterium freneyi	134034	S	1771	1267	3038	0.00016
Corynebacterium vitaeruminis	38305	S	1619	597	2216	0.00012
Corynebacterium maris	575200	S	1474	313	1787	0.00009
Corynebacterium humireducens	1223514	S	1465	649	2114	0.00011
Corynebacterium variabile	1727	S	1364	927	2291	0.00012
Corynebacterium doosanense	1121358	S	1345	752	2097	0.00011
Corynebacterium timonense	441500	S	1234	412	1646	0.00009
Corynebacterium marinum	349751	S	1210	915	2125	0.00011
Corynebacterium yudongzhengii	2080740	S	1168	359	1527	0.00008
Corynebacterium comes	2675218	S	1095	511	1606	0.00008
Corynebacterium liangguodongii	2079535	S	1079	358	1437	0.00008
Corynebacterium terpenotabidum	89154	S	1070	458	1528	0.00008
Corynebacterium provencense	1737425	S	1069	288	1357	0.00007
Gordonia sp. PP30	2935861	S	3522	951	4473	0.00023
Gordonia sp. YC-JH1	2059875	S	2657	1747	4404	0.00023
Gordonia sp. KTR9	337191	S	2623	1102	3725	0.00020
Gordonia sp. PDNC005	2811424	S	1941	269	2210	0.00012
Gordonia polyisoprenivorans	84595	S	6047	1426	7473	0.00039
Gordonia terrae	2055	S	4209	6751	10960	0.00057
Gordonia insulae	2420509	S	3623	750	4373	0.00023
Gordonia phthalatica	1136941	S	3150	1217	4367	0.00023
Gordonia amarae	36821	S	3098	608	3706	0.00019
Gordonia bronchialis	2054	S	3024	972	3996	0.00021
Gordonia jinghuaiqii	2758710	S	2991	643	3634	0.00019
Gordonia iterans	1004901	S	2776	844	3620	0.00019
Gordonia rubripertincta	36822	S	2633	3424	6057	0.00032
Gordonia pseudoamarae	2831662	S	2445	515	2960	0.00016
Gordonia otitidis	249058	S	2278	496	2774	0.00015
Gordonia zhaorongruii	2597659	S	1687	268	1955	0.00010
Skermania piniformis	39122	S	3204	326	3530	0.00018
Tsukamurella paurometabola	2061	S	6106	2522	8628	0.00045
Tsukamurella tyrosinosolvens	57704	S	5202	1948	7150	0.00037
Tsukamurella pulmonis	47312	S	3688	1100	4788	0.00025
Tsukamurella sp. PLM1	2929795	S	3571	974	4545	0.00024
Dietzia sp. oral taxon 368	712270	S	1945	3219	5164	0.00027
Dietzia lutea	546160	S	2233	1098	3331	0.00017
Dietzia psychralcaliphila	139021	S	2230	536	2766	0.00014
Dietzia timorensis	499555	S	1667	775	2442	0.00013
Tomitella gaofuii	2760083	S	3426	907	4333	0.00023
Tomitella fengzijianii	2597660	S	3147	897	4044	0.00021
Segniliparus rotundus	286802	S	1582	73	1655	0.00009
Nocardioides sp. G188	2849501	S	130220	35721	165941	0.00869
Nocardioides sp. LMS-CY	2840457	S	23517	7121	30638	0.00160
Nocardioides sp. JS614	196162	S	22172	6131	28303	0.00148
Nocardioides sp. HDW12B	2714939	S	16061	4682	20743	0.00109
Nocardioides sp. W7	2931390	S	15030	4766	19796	0.00104
Nocardioides sp. zg-579	2663857	S	14432	6826	21258	0.00111
Nocardioides sp. TF02-7	2917724	S	14400	4238	18638	0.00098
Nocardioides sp. cx-173	2898796	S	13769	4388	18157	0.00095
Nocardioides sp. S-1144	2582905	S	13732	4871	18603	0.00097
Nocardioides sp. InS609-2	2760705	S	12418	2629	15047	0.00079
Nocardioides sp. 603	2483798	S	11778	5074	16852	0.00088
Nocardioides sp. SCSIO 67246	2872154	S	11346	2743	14089	0.00074
Nocardioides sp. zg-1228	2763008	S	11239	4612	15851	0.00083
Nocardioides sp. S5	2017486	S	11184	5352	16536	0.00087
Nocardioides sp. CF8	110319	S	10194	4024	14218	0.00074
Nocardioides sp. MC1495	2736757	S	9730	3179	12909	0.00068
Nocardioides sp. JQ2195	2592334	S	9160	1741	10901	0.00057
Nocardioides sp. zg-536	2803858	S	8513	3408	11921	0.00062
Nocardioides sp. dk884	2662361	S	7873	8503	16376	0.00086
Nocardioides sp. ZJ1313	2685869	S	7388	8054	15442	0.00081
Nocardioides sp. Kera G14	2884264	S	7344	1376	8720	0.00046
Nocardioides sp. WS12	2486272	S	7155	1158	8313	0.00044
Nocardioides ungokensis	1643322	S	65899	21209	87108	0.00456
Nocardioides mesophilus	433659	S	34707	9344	44051	0.00231
Nocardioides cynanchi	2558918	S	24116	5173	29289	0.00153
Nocardioides anomalus	2712223	S	21440	5923	27363	0.00143
Nocardioides dongkuii	2760089	S	13333	6176	19509	0.00102
Nocardioides okcheonensis	2894081	S	13198	5639	18837	0.00099
Nocardioides euryhalodurans	2518370	S	13035	3640	16675	0.00087
Nocardioides humi	449461	S	12858	3976	16834	0.00088
Nocardioides aromaticivorans	200618	S	11623	4092	15715	0.00082
Nocardioides aquaticus	160826	S	11415	3205	14620	0.00077
Nocardioides rotundus	1774216	S	10643	3680	14323	0.00075
Nocardioides marinisabuli	419476	S	10593	5527	16120	0.00084
Nocardioides dokdonensis	450734	S	9703	4317	14020	0.00073
Nocardioides sambongensis	2589074	S	8640	2243	10883	0.00057
Nocardioides seonyuensis	2518371	S	7545	1878	9423	0.00049
Nocardioides houyundeii	2045452	S	7381	2063	9444	0.00049
Nocardioides panacisoli	627624	S	7056	1564	8620	0.00045
Nocardioides piscis	2714938	S	6862	2510	9372	0.00049
Nocardioides daphniae	402297	S	5722	2413	8135	0.00043
Nocardioides jishulii	2575440	S	4729	1604	6333	0.00033
Nocardioides baekrokdamisoli	1804624	S	3533	397	3930	0.00021
Nocardioides yefusunii	2500546	S	3498	914	4412	0.00023
Aeromicrobium sp. Leaf245	1736306	S	4933	1318	6251	0.00033
Aeromicrobium sp. zg-629	2663859	S	3991	1138	5129	0.00027
Aeromicrobium sp. A1-2	2107713	S	3642	447	4089	0.00021
Aeromicrobium erythreum	2041	S	5734	1472	7206	0.00038
Aeromicrobium chenweiae	2079793	S	5602	1646	7248	0.00038
Aeromicrobium choanae	1736691	S	5068	1310	6378	0.00033
Aeromicrobium yanjiei	2662028	S	4973	1361	6334	0.00033
Aeromicrobium marinum	219314	S	4114	768	4882	0.00026
Marmoricola scoriae	642780	S	13268	4381	17649	0.00092
Friedmanniella luteola	546871	S	10962	1851	12813	0.00067
Pimelobacter simplex	2045	S	10641	3547	14188	0.00074
Mumia sp. ZJ1417	2708082	S	6597	988	7585	0.00040
Micropruina glycogenica	75385	S	3405	416	3821	0.00020
Microlunatus sagamiharensis	546874	S	9536	1850	11386	0.00060
Microlunatus phosphovorus	29405	S	6082	608	6690	0.00035
Microlunatus soli	630515	S	5809	499	6308	0.00033
Microlunatus elymi	2596828	S	4994	485	5479	0.00029
Microlunatus sp. Gsoil 973	2672569	S	4452	306	4758	0.00025
Tessaracoccus sp. J1M15	2829499	S	3071	798	3869	0.00020
Tessaracoccus sp. MC1865	2760310	S	2068	479	2547	0.00013
Tessaracoccus aquimaris	1332264	S	3148	1278	4426	0.00023
Tessaracoccus defluvii	1285901	S	3121	1767	4888	0.00026
Tessaracoccus flavescens	399497	S	2557	1733	4290	0.00022
Tessaracoccus flavus	1610493	S	2165	1347	3512	0.00018
Tessaracoccus timonensis	2161816	S	1305	474	1779	0.00009
Brevilactibacter coleopterorum	2714937	S	4515	1679	6194	0.00032
Brevilactibacter sp. MC1595	2819349	S	3843	1253	5096	0.00027
Acidipropionibacterium acidipropionici	1748	S	2625	1331	3956	0.00021
Acidipropionibacterium jensenii	1749	S	2577	1345	3922	0.00021
Acidipropionibacterium virtanenii	2057246	S	1723	281	2004	0.00010
Propionibacterium acidifaciens	556499	S	2665	525	3190	0.00017
Propionibacterium freudenreichii	1744	S	1942	1327	3269	0.00017
Propionibacterium australiense	119981	S	1854	278	2132	0.00011
Auraticoccus monumenti	675864	S	6041	921	6962	0.00036
Raineyella fluvialis	2662261	S	3256	370	3626	0.00019
Arachnia propionica	1750	S	2061	212	2273	0.00012
Arachnia rubra	1547448	S	1019	107	1126	0.00006
Cutibacterium avidum	33010	S	1466	461	1927	0.00010
Kribbella flavida	182640	S	28086	5595	33681	0.00176
Kribbella qitaiheensis	1544730	S	22698	3112	25810	0.00135
Actinopolymorpha singaporensis	117157	S	15177	1416	16593	0.00087
Amycolatopsis sp. WQ 127309	2932773	S	26423	6014	32437	0.00170
Amycolatopsis sp. Hca4	2742131	S	25581	7481	33062	0.00173
Amycolatopsis sp. DSM 110486	2865832	S	17602	3001	20603	0.00108
Amycolatopsis sp. FDAARGOS 1241	2778070	S	12654	2363	15017	0.00079
Amycolatopsis sp. CA-230715	2745196	S	10853	1372	12225	0.00064
Amycolatopsis sp. YIM 10	2653857	S	9903	2314	12217	0.00064
Amycolatopsis sp. FU40	2914159	S	7752	3104	10856	0.00057
Amycolatopsis sp. AA4	1896961	S	6869	3198	10067	0.00053
Amycolatopsis sp. BJA-103	1911175	S	5740	1861	7601	0.00040
Amycolatopsis sp. TNS106	2861750	S	4517	2153	6670	0.00035
Amycolatopsis sp. EV170708-02-1	2919322	S	3745	2886	6631	0.00035
Amycolatopsis pretoriensis	218821	S	72336	18161	90497	0.00474
Amycolatopsis mediterranei	33910	S	25725	20995	46720	0.00245
Amycolatopsis methanolica	1814	S	17332	5452	22784	0.00119
Amycolatopsis acidiphila	715473	S	13917	2427	16344	0.00086
Amycolatopsis thermalba	944492	S	10050	3328	13378	0.00070
Amycolatopsis keratiniphila	129921	S	5372	3527	8899	0.00047
Amycolatopsis japonica	208439	S	2841	2161	5002	0.00026
Amycolatopsis albispora	1804986	S	8670	4024	12694	0.00066
Amycolatopsis aidingensis	2842453	S	7039	686	7725	0.00040
Amycolatopsis orientalis	31958	S	6062	1580	7642	0.00040
Pseudonocardia sp. DSM 110487	2865833	S	47709	5750	53459	0.00280
Pseudonocardia sp. CGMCC 4.1532	2761535	S	17052	9721	26773	0.00140
Pseudonocardia sp. HH130630-07	1690815	S	11321	8436	19757	0.00103
Pseudonocardia sp. AL041005-10	445576	S	9591	6815	16406	0.00086
Pseudonocardia sp. HH130629-09	1641402	S	7917	9958	17875	0.00094
Pseudonocardia broussonetiae	2736640	S	24368	7384	31752	0.00166
Pseudonocardia dioxanivorans	240495	S	24333	5474	29807	0.00156
Pseudonocardia abyssalis	2792008	S	13286	6707	19993	0.00105
Pseudonocardia autotrophica	2074	S	12539	2991	15530	0.00081
Saccharopolyspora erythraea	1836	S	16929	4415	21344	0.00112
Saccharopolyspora gregorii	33914	S	13482	2295	15777	0.00083
Saccharopolyspora spinosa	60894	S	4519	2509	7028	0.00037
Saccharopolyspora pogona	333966	S	3996	4155	8151	0.00043
Saccharopolyspora sp. ASAGF58	2719023	S	2637	3045	5682	0.00030
Saccharothrix syringae	103733	S	13696	4041	17737	0.00093
Saccharothrix sp. 6-C	2781735	S	11809	3437	15246	0.00080
Saccharothrix espanaensis	103731	S	10750	2692	13442	0.00070
Kutzneria sp. CA-103260	2802641	S	15503	2791	18294	0.00096
Kutzneria albida	43357	S	10146	1948	12094	0.00063
Saccharomonospora marina	632569	S	5680	1146	6826	0.00036
Saccharomonospora azurea	40988	S	4185	1149	5334	0.00028
Saccharomonospora cyanea	40989	S	3727	1246	4973	0.00026
Saccharomonospora xinjiangensis	75294	S	3085	455	3540	0.00019
Saccharomonospora glauca	40990	S	2901	962	3863	0.00020
Saccharomonospora viridis	1852	S	2412	329	2741	0.00014
Lentzea guizhouensis	1586287	S	17241	3032	20273	0.00106
Actinosynnema pretiosum	42197	S	4532	11912	16444	0.00086
Actinoalloteichus hoggarensis	1470176	S	4702	4666	9368	0.00049
Actinoalloteichus hymeniacidonis	340345	S	3704	1213	4917	0.00026
Allokutzneria albata	211114	S	12936	2576	15512	0.00081
Kibdelosporangium phytohabitans	860235	S	12253	1229	13482	0.00071
Alloactinosynnema sp. L-07	1653480	S	8097	1493	9590	0.00050
Prauserella marina	530584	S	4948	377	5325	0.00028
Allosaccharopolyspora coralli	2665642	S	4125	747	4872	0.00026
Micromonospora sp. WMMC415	2675222	S	7494	2443	9937	0.00052
Micromonospora sp. WMMA2032	2039870	S	6373	3737	10110	0.00053
Micromonospora sp. HM134	2583243	S	6237	2509	8746	0.00046
Micromonospora sp. B006	2201999	S	5142	3688	8830	0.00046
Micromonospora terminaliae	1914461	S	13170	5901	19071	0.00100
Micromonospora carbonacea	47853	S	8916	3447	12363	0.00065
Micromonospora krabiensis	307121	S	8800	2626	11426	0.00060
Micromonospora echinofusca	47858	S	8687	3441	12128	0.00064
Micromonospora inositola	47865	S	8282	3620	11902	0.00062
Micromonospora echinaurantiaca	47857	S	8261	3516	11777	0.00062
Micromonospora auratinigra	261654	S	7544	3534	11078	0.00058
Micromonospora ferruginea	2749844	S	7317	3787	11104	0.00058
Micromonospora viridifaciens	1881	S	7081	2748	9829	0.00051
Micromonospora purpureochromogenes	47872	S	7040	3300	10340	0.00054
Micromonospora siamensis	299152	S	6953	2930	9883	0.00052
Micromonospora coxensis	356852	S	6831	3345	10176	0.00053
Micromonospora coriariae	285665	S	6811	2151	8962	0.00047
Micromonospora echinospora	1877	S	6621	2047	8668	0.00045
Micromonospora narathiwatensis	299146	S	6463	2721	9184	0.00048
Micromonospora zamorensis	709883	S	5967	1703	7670	0.00040
Micromonospora sagamiensis	47875	S	5921	2013	7934	0.00042
Micromonospora chokoriensis	356851	S	5818	1674	7492	0.00039
Micromonospora maris	1003110	S	5715	1518	7233	0.00038
Micromonospora endophytica (Xie et al. 2001) Li et al. 2019	515350	S	5601	1503	7104	0.00037
Micromonospora rifamycinica	291594	S	5567	2244	7811	0.00041
Micromonospora craniellae	2294034	S	4464	2563	7027	0.00037
Micromonospora tulbaghiae	479978	S	3792	3910	7702	0.00040
Micromonospora aurantiaca	47850	S	2716	18485	21201	0.00111
Actinoplanes sp. L3-i22	2836373	S	26091	17599	43690	0.00229
Actinoplanes sp. N902-109	649831	S	18827	5060	23887	0.00125
Actinoplanes sp. OR16	946334	S	16295	7190	23485	0.00123
Actinoplanes friuliensis	196914	S	19139	2707	21846	0.00114
Actinoplanes ianthinogenes	122358	S	18727	6797	25524	0.00134
Actinoplanes missouriensis	1866	S	14595	4314	18909	0.00099
Actinoplanes teichomyceticus	1867	S	14501	5498	19999	0.00105
Actinoplanes derwentensis	113562	S	12543	1695	14238	0.00075
Dactylosporangium vinaceum	53362	S	37561	3549	41110	0.00215
Phytohabitans suffuscus	624315	S	15256	3335	18591	0.00097
Phytohabitans flavus	1076124	S	12316	2080	14396	0.00075
Couchioplanes caeruleus	56438	S	23034	5144	28178	0.00148
Plantactinospora sp. KBS50	2024580	S	9267	2014	11281	0.00059
Plantactinospora sp. BC1	2108470	S	2013	5358	7371	0.00039
Plantactinospora sp. BB1	2071627	S	2000	5266	7266	0.00038
Actinocatenispora thailandica	227318	S	9535	2277	11812	0.00062
Actinocatenispora sera	390989	S	9376	2355	11731	0.00061
Catellatospora sp. IY07-71	2728827	S	15648	2943	18591	0.00097
Polymorphospora rubra	338584	S	10586	2049	12635	0.00066
Natronosporangium hydrolyticum	2811111	S	5990	346	6336	0.00033
Verrucosispora sp. NA02020	2742132	S	4804	3452	8256	0.00043
Salinispora tropica	168695	S	3492	523	4015	0.00021
Actinomadura sp. WMMA1423	2591108	S	31893	8131	40024	0.00210
Actinomadura sp. NAK00032	2742128	S	22613	6868	29481	0.00154
Actinomadura sp. WMMB 499	1219491	S	16181	3255	19436	0.00102
Actinomadura verrucosospora	46165	S	49420	12598	62018	0.00325
Actinomadura madurae	1993	S	28207	7170	35377	0.00185
Actinomadura graeca	2750812	S	13992	2724	16716	0.00088
Thermomonospora amylolytica	1411117	S	10641	3379	14020	0.00073
Thermomonospora curvata	2020	S	6971	1781	8752	0.00046
Nonomuraea coxensis	404386	S	47982	11698	59680	0.00313
Nonomuraea nitratireducens	2656914	S	20911	3820	24731	0.00130
Nonomuraea sp. ATCC 55076	1909395	S	20548	5681	26229	0.00137
Nonomuraea gerenzanensis	93944	S	18185	5272	23457	0.00123
Streptosporangium roseum	2001	S	18756	4363	23119	0.00121
Streptosporangium sp. 'caverna'	2202249	S	16021	2949	18970	0.00099
Thermobispora bispora	2006	S	7557	1439	8996	0.00047
Nocardiopsis sp. MT53	2865672	S	6711	1349	8060	0.00042
Nocardiopsis sp. HDS12	2831968	S	2099	1817	3916	0.00021
Nocardiopsis gilva	280236	S	4950	836	5786	0.00030
Nocardiopsis dassonvillei	2014	S	3906	3272	7178	0.00038
Nocardiopsis alba	53437	S	3746	575	4321	0.00023
Thermobifida alba	53522	S	3978	1331	5309	0.00028
Thermobifida halotolerans	483545	S	3961	1079	5040	0.00026
Thermobifida fusca	2021	S	1962	283	2245	0.00012
Streptomonospora litoralis	2498135	S	5620	920	6540	0.00034
Spiractinospora alimapuensis	2820884	S	3854	211	4065	0.00021
Blastococcus sp. PRF04-17	2933797	S	36800	11053	47853	0.00251
Blastococcus saxobsidens	138336	S	27745	7513	35258	0.00185
Modestobacter marinus	477641	S	29004	9000	38004	0.00199
Modestobacter sp. L9-4	2851567	S	17082	5837	22919	0.00120
Geodermatophilus obscurus	1861	S	31641	9364	41005	0.00215
Nakamurella multipartita	53461	S	39790	6058	45848	0.00240
Nakamurella panacisegetis	1090615	S	4845	503	5348	0.00028
Nakamurella sp. PAMC28650	2762325	S	4590	365	4955	0.00026
Frankia inefficax	298654	S	16173	1600	17773	0.00093
Frankia sp. QA3	710111	S	5857	2119	7976	0.00042
Frankia sp. ArI3	1858	S	4755	2719	7474	0.00039
Candidatus Frankia datiscae	2716812	S	5307	652	5959	0.00031
Frankia alni	1859	S	4972	2959	7931	0.00042
Frankia casuarinae	106370	S	4789	427	5216	0.00027
Actinomyces sp. oral taxon 414	712122	S	2070	870	2940	0.00015
Actinomyces sp. MAS-1	2755559	S	1488	500	1988	0.00010
Actinomyces sp. Z16	2079536	S	1314	1358	2672	0.00014
Actinomyces sp. Chiba101	1851395	S	1147	1136	2283	0.00012
Actinomyces sp. 432	2057798	S	1055	703	1758	0.00009
Actinomyces radicidentis	111015	S	2708	1100	3808	0.00020
Actinomyces howellii	52771	S	2078	385	2463	0.00013
Actinomyces respiraculi	2744574	S	1586	633	2219	0.00012
Actinomyces slackii	52774	S	1433	326	1759	0.00009
Actinomyces procaprae	2560010	S	1230	950	2180	0.00011
Actinomyces faecalis	2722820	S	1085	192	1277	0.00007
Actinomyces viscosus	1656	S	1068	909	1977	0.00010
Actinomyces qiguomingii	2057800	S	1053	253	1306	0.00007
Schaalia odontolytica	1660	S	1355	334	1689	0.00009
Flaviflexus salsibiostraticola	1282737	S	1302	301	1603	0.00008
Pauljensenia hongkongensis	178339	S	1257	404	1661	0.00009
Nanchangia anserum	2692125	S	1025	99	1124	0.00006
Jiangella sp. DSM 45060	1798224	S	12911	3265	16176	0.00085
Jiangella alkaliphila	419479	S	12158	2954	15112	0.00079
Bifidobacterium pseudolongum	1694	S	1569	591	2160	0.00011
Bifidobacterium choerinum	35760	S	1530	591	2121	0.00011
Bifidobacterium scardovii	158787	S	1411	141	1552	0.00008
Bifidobacterium longum	216816	S	1346	3375	4721	0.00025
Catenulispora acidiphila	304895	S	14693	1755	16448	0.00086
Jatrophihabitans telluris	2038343	S	5698	427	6125	0.00032
Jatrophihabitans sp. GAS493	1907575	S	5276	422	5698	0.00030
Stackebrandtia nassauensis	283811	S	5823	442	6265	0.00033
Kineococcus radiotolerans	131568	S	6654	1510	8164	0.00043
Epidermidibacterium keratini	1891644	S	3766	1466	5232	0.00027
Actinopolyspora erythraea	414996	S	3225	271	3496	0.00018
Acidothermus cellulolyticus	28049	S	1923	83	2006	0.00011
Conexibacter sp. SYSU D00693	2812560	S	79324	16657	95981	0.00503
Conexibacter sp. DBS9H8	2937801	S	19008	1640	20648	0.00108
Conexibacter sp. S30A1	2937800	S	18995	1812	20807	0.00109
Conexibacter woesei	191495	S	85383	13363	98746	0.00517
Miltoncostaea marina	2843215	S	19067	4213	23280	0.00122
Miltoncostaea oceani	2843216	S	19006	2505	21511	0.00113
Baekduia soli	496014	S	93351	12749	106100	0.00556
Rubrobacter xylanophilus	49319	S	10216	1119	11335	0.00059
Rubrobacter marinus	2653852	S	6673	507	7180	0.00038
Rubrobacter tropicus	2653851	S	5889	376	6265	0.00033
Rubrobacter radiotolerans	42256	S	3123	357	3480	0.00018
Rubrobacter indicoceani	2051957	S	1664	114	1778	0.00009
Aquihabitans sp. Kera 3	2884263	S	14870	2001	16871	0.00088
Aquihabitans sp. G128	2849779	S	12577	2126	14703	0.00077
Iamia sp. SCSIO 61187	2722752	S	12171	1625	13796	0.00072
Actinomarinicola tropica	2789776	S	11793	1953	13746	0.00072
Ilumatobacter coccineus	467094	S	6019	314	6333	0.00033
Acidimicrobium ferrooxidans	53635	S	2119	141	2260	0.00012
Eggerthella lenta	84112	S	1788	1468	3256	0.00017
Eggerthella guodeyinii	2690837	S	1634	810	2444	0.00013
Arabiibacter massiliensis	1870985	S	1839	549	2388	0.00013
Olsenella timonensis	1805478	S	1498	511	2009	0.00011
Thermophilibacter immobilis	2779519	S	1013	379	1392	0.00007
Collinsella aerofaciens	74426	S	1569	989	2558	0.00013
Egibacter rhizosphaerae	1670831	S	6456	299	6755	0.00035
Egicoccus halophilus	1670830	S	5892	717	6609	0.00035
Euzebya pacifica	1608957	S	5831	373	6204	0.00033
Priestia megaterium	1404	S	32053	33404	65457	0.00343
[Brevibacterium] frigoritolerans	450367	S	1770	5151	6921	0.00036
Neobacillus drentensis	220684	S	1926	877	2803	0.00015
Peribacillus simplex	1478	S	1422	720	2142	0.00011
Hydrogenibacillus sp. N12	2866627	S	2047	385	2432	0.00013
Paenibacillus sp. B01	2660554	S	2586	3017	5603	0.00029
Paenibacillus sp. RUD330	2023772	S	1484	362	1846	0.00010
Paenibacillus sp. JZ16	1906272	S	1351	2187	3538	0.00019
Paenibacillus sp. HWE-109	1306526	S	1290	257	1547	0.00008
Paenibacillus sp. 32O-W	1695218	S	1211	195	1406	0.00007
Paenibacillus mucilaginosus	61624	S	2290	302	2592	0.00014
Paenibacillus albicereus	2726185	S	2276	2469	4745	0.00025
Paenibacillus lycopersici	2704462	S	1927	471	2398	0.00013
Paenibacillus cellulositrophicus	562959	S	1414	322	1736	0.00009
Paenibacillus albus	2495582	S	1239	286	1525	0.00008
Paenibacillus rhizovicinus	2704463	S	1219	331	1550	0.00008
Paenibacillus konkukensis	2020716	S	1034	243	1277	0.00007
Cohnella candidum	2674991	S	1284	268	1552	0.00008
Thermobacillus composti	377615	S	2060	409	2469	0.00013
Saccharibacillus brassicae	2583377	S	1590	238	1828	0.00010
Alicyclobacillus acidocaldarius	405212	S	2325	202	2527	0.00013
Tumebacillus avium	1903704	S	1355	596	1951	0.00010
Faecalibacterium prausnitzii	853	S	1905	2849	4754	0.00025
Flavonifractor plautii	292800	S	1199	531	1730	0.00009
Thermaerobacter sp. FW80	2546351	S	2679	586	3265	0.00017
Thermaerobacter sp. PB12/4term	2293838	S	1782	444	2226	0.00012
Thermaerobacter marianensis	73919	S	2278	553	2831	0.00015
Symbiobacterium thermophilum	2734	S	3061	338	3399	0.00018
Gelria sp. Kuro-4	2796927	S	1069	175	1244	0.00007
Selenomonas sputigena	69823	S	1057	398	1455	0.00008
Limnochorda pilosa	1555112	S	2848	103	2951	0.00015
Deinococcus sp. NW-56	2080419	S	1836	228	2064	0.00011
Deinococcus sp. TS-293	2737050	S	1768	160	1928	0.00010
Deinococcus sp. KNUC1210	2917691	S	1496	53	1549	0.00008
Deinococcus sp. AJ005	2652443	S	1033	77	1110	0.00006
Deinococcus actinosclerus	1768108	S	2591	1458	4049	0.00021
Deinococcus gobiensis	502394	S	2584	304	2888	0.00015
Deinococcus maricopensis	309887	S	2473	189	2662	0.00014
Deinococcus ficus	317577	S	2348	194	2542	0.00013
Deinococcus metallilatus	1211322	S	2264	230	2494	0.00013
Deinococcus irradiatisoli	2202254	S	1727	138	1865	0.00010
Deinococcus peraridilitoris	432329	S	1495	64	1559	0.00008
Deinococcus wulumuqiensis	980427	S	1488	513	2001	0.00010
Deinococcus radiopugnans	57497	S	1344	148	1492	0.00008
Deinococcus radiodurans	1299	S	1203	508	1711	0.00009
Deinococcus geothermalis	68909	S	1143	160	1303	0.00007
Deinococcus soli (ex Cha et al. 2016)	1309411	S	1106	976	2082	0.00011
Thermus thermophilus	274	S	1062	1737	2799	0.00015
Oceanithermus profundus	187137	S	2821	255	3076	0.00016
Marinithermus hydrothermalis	186192	S	1662	258	1920	0.00010
Truepera radiovictrix	332249	S	2538	117	2655	0.00014
Synechococcus sp. CBW1004	1353136	S	1329	3391	4720	0.00025
Synechococcus sp. RSCCF101	2511069	S	1062	437	1499	0.00008
Cyanobium sp. NIES-981	1851505	S	1101	594	1695	0.00009
Cyanobium gracile	59930	S	1436	476	1912	0.00010
Oscillatoria nigro-viridis	482564	S	2995	961	3956	0.00021
Microcoleus vaginatus	119532	S	1119	242	1361	0.00007
Leptolyngbya sp. 7M	2812896	S	1155	166	1321	0.00007
Gloeobacter kilaueensis	1416614	S	1573	67	1640	0.00009
Gloeobacter morelensis	2907343	S	1030	424	1454	0.00008
Gloeobacter violaceus	33072	S	1002	457	1459	0.00008
Sphaerobacter thermophilus	2057	S	7629	415	8044	0.00042
Thermomicrobium roseum	500	S	1763	36	1799	0.00009
Roseiflexus castenholzii	120962	S	2773	433	3206	0.00017
Roseiflexus sp. RS-1	357808	S	2738	404	3142	0.00016
Chloroflexus aurantiacus	1108	S	1041	128	1169	0.00006
Tepidiforma bonchosmolovskayae	2601677	S	4727	169	4896	0.00026
Candidatus Promineofilum breve	1806508	S	4375	74	4449	0.00023
Ktedonosporobacter rubrisoli	2509675	S	2453	64	2517	0.00013
Caldilinea aerophila	133453	S	2091	117	2208	0.00012
Fimbriimonas ginsengisoli	1005039	S	2517	12	2529	0.00013
Bradyrhizobium sp. 200	2782665	S	72035	15157	87192	0.00457
Bradyrhizobium sp. 170	2782641	S	56567	13592	70159	0.00367
Bradyrhizobium sp. CCBAU 051011	858422	S	32079	4975	37054	0.00194
Bradyrhizobium sp. CCBAU 51753	1325100	S	28960	4962	33922	0.00178
Bradyrhizobium sp. CCBAU 53338	1325111	S	21341	7074	28415	0.00149
Bradyrhizobium sp. CCBAU 53351	1325114	S	20199	8402	28601	0.00150
Bradyrhizobium sp. 195	2782662	S	19607	6294	25901	0.00136
Bradyrhizobium sp. SK17	2057741	S	16266	4242	20508	0.00107
Bradyrhizobium sp. 186	2782654	S	15348	3824	19172	0.00100
Bradyrhizobium sp. CCBAU 53421	1325120	S	14527	3837	18364	0.00096
Bradyrhizobium sp. A19	2898149	S	13604	1848	15452	0.00081
Bradyrhizobium sp. CCBAU 53340	1325112	S	13325	4200	17525	0.00092
Bradyrhizobium sp. BTAi1	288000	S	12923	1855	14778	0.00077
Bradyrhizobium sp. ORS 285	115808	S	12633	2344	14977	0.00078
Bradyrhizobium sp. ORS 278	114615	S	12457	2313	14770	0.00077
Bradyrhizobium sp. 1(2017)	1404888	S	11857	3124	14981	0.00078
Bradyrhizobium sp. 6(2017)	1197460	S	10739	4324	15063	0.00079
Bradyrhizobium sp. CCGE-LA001	1223566	S	8040	2513	10553	0.00055
Bradyrhizobium sp. S2-11-2	2840472	S	7961	6610	14571	0.00076
Bradyrhizobium sp. 41S5	1404443	S	7837	4477	12314	0.00065
Bradyrhizobium sp. S2-20-1	2840469	S	6561	5896	12457	0.00065
Bradyrhizobium sp. S2-11-4	2840473	S	6260	6216	12476	0.00065
Bradyrhizobium sp. I71	2590772	S	6238	5838	12076	0.00063
Bradyrhizobium sp. CCBAU 51765	1325102	S	6031	5754	11785	0.00062
Bradyrhizobium sp. 191	2782659	S	5984	6288	12272	0.00064
Bradyrhizobium sp. C-145	574727	S	3977	3254	7231	0.00038
Bradyrhizobium sp.	376	S	3397	9369	12766	0.00067
Bradyrhizobium sp. 144S4	2823807	S	3275	7281	10556	0.00055
Bradyrhizobium sp. 323S2	1404649	S	3061	6875	9936	0.00052
Bradyrhizobium sp. 40	2782674	S	2688	6738	9426	0.00049
Bradyrhizobium sp. 4	2782678	S	2374	6735	9109	0.00048
Bradyrhizobium sp. 192	2782660	S	2312	4908	7220	0.00038
Bradyrhizobium sp. LCT2	2493093	S	1479	3366	4845	0.00025
Bradyrhizobium sp. SG09	2599805	S	1122	7140	8262	0.00043
Bradyrhizobium sp. TM102	2599819	S	1097	6749	7846	0.00041
Bradyrhizobium erythrophlei	1437360	S	58872	3375	62247	0.00326
Bradyrhizobium diazoefficiens	1355477	S	49928	68928	118856	0.00623
Bradyrhizobium paxllaeri	190148	S	27302	3738	31040	0.00163
Bradyrhizobium icense	1274631	S	25121	2498	27619	0.00145
Bradyrhizobium japonicum	375	S	22405	26148	48553	0.00254
Bradyrhizobium lablabi	722472	S	19171	17415	36586	0.00192
Bradyrhizobium canariense	255045	S	17787	22649	40436	0.00212
Bradyrhizobium arachidis	858423	S	17702	3865	21567	0.00113
Bradyrhizobium genosp. L	83637	S	16563	2413	18976	0.00099
Bradyrhizobium guangdongense	1325090	S	14992	4362	19354	0.00101
Bradyrhizobium guangzhouense	1325095	S	14770	4358	19128	0.00100
Bradyrhizobium genosp. B	83627	S	11713	1852	13565	0.00071
Bradyrhizobium oligotrophicum	44255	S	11417	1422	12839	0.00067
Bradyrhizobium quebecense	2748629	S	11304	4971	16275	0.00085
Bradyrhizobium guangxiense	1325115	S	10735	3628	14363	0.00075
Bradyrhizobium cosmicum	1404864	S	10681	2644	13325	0.00070
Bradyrhizobium vignae	1549949	S	10036	1761	11797	0.00062
Bradyrhizobium septentrionale	1404411	S	9314	4417	13731	0.00072
Bradyrhizobium symbiodeficiens	1404367	S	8801	10560	19361	0.00101
Bradyrhizobium amphicarpaeae	1404768	S	8303	2646	10949	0.00057
Bradyrhizobium elkanii	29448	S	7586	18854	26440	0.00138
Bradyrhizobium betae	244734	S	7122	2921	10043	0.00053
Bradyrhizobium daqingense	993502	S	6360	2672	9032	0.00047
Bradyrhizobium zhanjiangense	1325107	S	3774	3020	6794	0.00036
Bradyrhizobium ottawaense	931866	S	2413	11989	14402	0.00075
Rhodopseudomonas palustris	1076	S	33335	7874	41209	0.00216
Rhodopseudomonas sp. SK50-23	340268	S	6906	1098	8004	0.00042
Rhodopseudomonas boonkerdii	475937	S	5897	1171	7068	0.00037
Nitrobacter hamburgensis	912	S	17811	2098	19909	0.00104
Nitrobacter winogradskyi	913	S	5745	683	6428	0.00034
Afipia carboxidovorans	40137	S	13773	2079	15852	0.00083
Afipia sp. GAS231	1882747	S	9330	4600	13930	0.00073
Tardiphaga sp. 37S4	1404741	S	3412	9984	13396	0.00070
Tardiphaga robiniae	943830	S	3536	2156	5692	0.00030
Variibacter gotjawalensis	1333996	S	7660	409	8069	0.00042
Mesorhizobium sp. B2-8-5	2589903	S	45198	9999	55197	0.00289
Mesorhizobium sp. J8	2777475	S	35858	7746	43604	0.00228
Mesorhizobium sp. M2A.F.Ca.ET.043.05.1.1	2493671	S	14790	8811	23601	0.00124
Mesorhizobium sp. M1E.F.Ca.ET.045.02.1.1	2493672	S	10593	3612	14205	0.00074
Mesorhizobium sp. M1B.F.Ca.ET.045.04.1.1	2493673	S	10329	2691	13020	0.00068
Mesorhizobium sp. M1D.F.Ca.ET.043.01.1.1	2493669	S	9752	4015	13767	0.00072
Mesorhizobium sp. B1-1-8	2589976	S	8593	1420	10013	0.00052
Mesorhizobium sp. M1A.F.Ca.IN.022.06.1.1	2493680	S	7836	1709	9545	0.00050
Mesorhizobium sp. M3A.F.Ca.ET.080.04.2.1	2493676	S	7625	1558	9183	0.00048
Mesorhizobium sp. M2A.F.Ca.ET.043.02.1.1	2493670	S	6945	12568	19513	0.00102
Mesorhizobium sp. M2A.F.Ca.ET.046.03.2.1	2493674	S	6696	12745	19441	0.00102
Mesorhizobium sp. 131-2-1	2744518	S	6338	2289	8627	0.00045
Mesorhizobium sp. 8	2584466	S	5729	879	6608	0.00035
Mesorhizobium sp. M4B.F.Ca.ET.058.02.1.1	2493675	S	5689	1629	7318	0.00038
Mesorhizobium sp. B2-1-1	2589974	S	5688	858	6546	0.00034
Mesorhizobium sp. INR15	2654248	S	4642	439	5081	0.00027
Mesorhizobium sp. PAMC28654	2880934	S	4525	559	5084	0.00027
Mesorhizobium sp. NZP2298	2483403	S	4079	1730	5809	0.00030
Mesorhizobium sp. Pch-S	2082387	S	3848	340	4188	0.00022
Mesorhizobium sp. DCY119	2108445	S	3788	547	4335	0.00023
Mesorhizobium sp. 113-3-3	2744516	S	3754	1445	5199	0.00027
Mesorhizobium sp. B2-1-8	2589967	S	3754	779	4533	0.00024
Mesorhizobium sp. B4-1-4	2589888	S	3635	586	4221	0.00022
Mesorhizobium sp. M8A.F.Ca.ET.057.01.1.1	2493679	S	3361	875	4236	0.00022
Mesorhizobium sp. 113-3-9	2744517	S	3317	1767	5084	0.00027
Mesorhizobium sp. M7D.F.Ca.US.005.01.1.1	2493678	S	3269	775	4044	0.00021
Mesorhizobium sp. L-2-11	2744521	S	3103	808	3911	0.00020
Mesorhizobium sp. 113-1-2	2744515	S	3077	1067	4144	0.00022
Mesorhizobium sp. M9A.F.Ca.ET.002.03.1.2	2493668	S	2959	936	3895	0.00020
Mesorhizobium sp. NZP2077	2483404	S	2919	666	3585	0.00019
Mesorhizobium sp. M6A.T.Cr.TU.016.01.1.1	2493677	S	2822	645	3467	0.00018
Mesorhizobium sp. M7A.F.Ce.TU.012.03.2.1	2493681	S	2447	631	3078	0.00016
Mesorhizobium sp. NZP2234	2483402	S	1844	5072	6916	0.00036
Mesorhizobium sp. L-8-10	2744523	S	1414	3215	4629	0.00024
Mesorhizobium sp. L-8-3	2744522	S	1407	3284	4691	0.00025
Mesorhizobium sp. NBSH29	2654249	S	1376	60	1436	0.00008
Mesorhizobium sp. AA22	1854057	S	1315	596	1911	0.00010
Mesorhizobium loti	381	S	4851	30690	35541	0.00186
Mesorhizobium opportunistum	593909	S	4188	1196	5384	0.00028
Mesorhizobium terrae	2725666	S	3887	793	4680	0.00025
Mesorhizobium amorphae	71433	S	3802	593	4395	0.00023
Mesorhizobium huakuii	28104	S	3051	2378	5429	0.00028
Mesorhizobium erdmanii	1777866	S	2494	486	2980	0.00016
Mesorhizobium japonicum	2066070	S	2284	1275	3559	0.00019
Mesorhizobium australicum	536018	S	2263	491	2754	0.00014
Mesorhizobium ciceri	39645	S	2152	4093	6245	0.00033
Aquibium microcysteis	675281	S	5759	1056	6815	0.00036
Aquibium oceanicum	1670800	S	3984	609	4593	0.00024
Aminobacter sp. MSH1	374606	S	3433	1470	4903	0.00026
Aminobacter sp. SR38	2774562	S	1237	6359	7596	0.00040
Nitratireductor sp. SY7	2599600	S	3579	420	3999	0.00021
Nitratireductor sp. OM-1	1756988	S	1938	251	2189	0.00011
Nitratireductor kimnyeongensis	430679	S	1113	132	1245	0.00007
Phyllobacterium sp. T1293	555317	S	1545	145	1690	0.00009
Phyllobacterium sp. T1018	555316	S	1417	128	1545	0.00008
Phyllobacterium zundukense	1867719	S	1541	151	1692	0.00009
Roseitalea porphyridii	1852022	S	2998	334	3332	0.00017
Hoeflea sp. IMCC20628	1620421	S	1372	93	1465	0.00008
Hoeflea phototrophica	244596	S	1181	99	1280	0.00007
Oricola thermophila	2742145	S	2203	201	2404	0.00013
Rhizobium sp. BG4	2613770	S	10778	1776	12554	0.00066
Rhizobium sp. WYJ-E13	2849093	S	5285	610	5895	0.00031
Rhizobium sp. NXC24	2048897	S	2515	358	2873	0.00015
Rhizobium sp. ACO-34A	1571470	S	1878	353	2231	0.00012
Rhizobium sp. 11515TR	2028343	S	1846	857	2703	0.00014
Rhizobium sp. SL42	2806346	S	1785	261	2046	0.00011
Rhizobium sp. AB2/73	2795216	S	1751	1464	3215	0.00017
Rhizobium sp. L51/94	2819999	S	1708	6778	8486	0.00044
Rhizobium sp. WL3	2603277	S	1680	287	1967	0.00010
Rhizobium sp. NZLR1	2731096	S	1548	683	2231	0.00012
Rhizobium sp. CIAT894	2020312	S	1532	905	2437	0.00013
Rhizobium sp. C104	2917727	S	1417	1108	2525	0.00013
Rhizobium sp. NXC14	1981173	S	1228	767	1995	0.00010
Rhizobium sp. NLR16a	2731112	S	1218	861	2079	0.00011
Rhizobium leguminosarum	384	S	13972	21744	35716	0.00187
Rhizobium etli	29449	S	3503	5054	8557	0.00045
Rhizobium jaguaris	1312183	S	2940	306	3246	0.00017
Rhizobium phaseoli	396	S	2161	5528	7689	0.00040
Rhizobium pseudoryzae	379684	S	2091	352	2443	0.00013
Rhizobium gallicum	56730	S	2085	3241	5326	0.00028
Rhizobium bangladeshense	1138189	S	1762	428	2190	0.00011
Rhizobium tropici	398	S	1746	470	2216	0.00012
Rhizobium lentis	1138194	S	1629	519	2148	0.00011
Rhizobium binae	1138190	S	1355	547	1902	0.00010
Rhizobium daejeonense	240521	S	1272	396	1668	0.00009
Rhizobium rosettiformans	1368430	S	1261	501	1762	0.00009
Rhizobium acidisoli	1538158	S	1095	1074	2169	0.00011
Rhizobium indicum	2583231	S	1037	1104	2141	0.00011
Rhizobium rhizoryzae	451876	S	1033	114	1147	0.00006
Agrobacterium tumefaciens	358	S	8239	10739	18978	0.00099
Agrobacterium fabrum	1176649	S	5719	8080	13799	0.00072
Agrobacterium vitis	373	S	3856	395	4251	0.00022
Agrobacterium sp. CGMCC 11546	2579248	S	1100	3248	4348	0.00023
Agrobacterium vaccinii	2735528	S	1393	163	1556	0.00008
Neorhizobium galegae	399	S	6478	1408	7886	0.00041
Neorhizobium sp. NCHU2750	1825976	S	2073	461	2534	0.00013
Neorhizobium sp. SOG26	2060726	S	1599	253	1852	0.00010
Pseudorhizobium flavum	1335061	S	1124	649	1773	0.00009
Pseudorhizobium banfieldiae	1125847	S	1056	551	1607	0.00008
Sinorhizobium fredii	380	S	6695	7899	14594	0.00076
Sinorhizobium meliloti	382	S	4933	1883	6816	0.00036
Sinorhizobium americanum	194963	S	2543	748	3291	0.00017
Sinorhizobium sp. BG8	2613773	S	2087	268	2355	0.00012
Sinorhizobium medicae	110321	S	2110	260	2370	0.00012
Ensifer adhaerens	106592	S	7064	4617	11681	0.00061
Ensifer mexicanus	375549	S	3071	365	3436	0.00018
Ensifer sp. PDNC004	2811423	S	1968	819	2787	0.00015
Ensifer alkalisoli	1752398	S	2152	355	2507	0.00013
Ensifer sojae	716925	S	2039	675	2714	0.00014
Shinella sp. HZN7	879274	S	4682	3267	7949	0.00042
Shinella sp. PSBB067	2715959	S	3365	2126	5491	0.00029
Shinella sp. XGS7	2877941	S	2925	2210	5135	0.00027
Shinella sp. H4-D48	2925841	S	1505	469	1974	0.00010
Shinella zoogloeoides	352475	S	3727	3985	7712	0.00040
Shinella oryzae	2871820	S	1960	681	2641	0.00014
Ciceribacter thiooxidans	1969821	S	2322	367	2689	0.00014
Georhizobium profundi	2341112	S	1880	283	2163	0.00011
Methylobacterium tardum	374432	S	14041	4114	18155	0.00095
Methylobacterium sp. WL1	2603276	S	4852	806	5658	0.00030
Methylobacterium sp. 17Sr1-1	2202826	S	4592	1819	6411	0.00034
Methylobacterium aquaticum	270351	S	9337	3396	12733	0.00067
Methylobacterium nodulans	114616	S	9168	889	10057	0.00053
Methylobacterium oryzae	334852	S	8569	9176	17745	0.00093
Methylobacterium durans	2202825	S	6788	733	7521	0.00039
Methylobacterium currus	2051553	S	6192	2121	8313	0.00044
Methylobacterium mesophilicum	39956	S	6084	1036	7120	0.00037
Methylobacterium radiodurans	2202828	S	6026	1123	7149	0.00037
Methylobacterium brachiatum	269660	S	5444	1535	6979	0.00037
Methylobacterium organophilum	410	S	4750	1884	6634	0.00035
Methylobacterium terrae	2202827	S	4705	1796	6501	0.00034
Methylobacterium indicum	1775910	S	4093	1700	5793	0.00030
Methylobacterium radiotolerans	31998	S	2307	11416	13723	0.00072
Methylobacterium phyllosphaerae	418223	S	1259	3993	5252	0.00028
Microvirga sp. VF16	2807101	S	11903	1512	13415	0.00070
Microvirga sp. 17 mud 1-3	2082949	S	5451	914	6365	0.00033
Microvirga ossetica	1882682	S	12386	1794	14180	0.00074
Microvirga thermotolerans	2651334	S	5850	1274	7124	0.00037
Methylorubrum populi	223967	S	8590	3246	11836	0.00062
Methylorubrum extorquens	408	S	6904	9226	16130	0.00084
Methylorubrum sp. B1-46	2897334	S	2926	892	3818	0.00020
Labrys sp. KNU-23	2789216	S	81562	5917	87479	0.00458
Pseudolabrys taiwanensis	331696	S	25575	3212	28787	0.00151
Pseudolabrys sp. FHR47	2562284	S	15696	2098	17794	0.00093
Starkeya sp. ORNL1	2709380	S	8802	1324	10126	0.00053
Starkeya novella	921	S	6122	1767	7889	0.00041
Ancylobacter polymorphus	223390	S	4775	1901	6676	0.00035
Ancylobacter sp. TS-1	1850374	S	4603	1472	6075	0.00032
Ancylobacter pratisalsi	1745854	S	3866	654	4520	0.00024
Xanthobacter dioxanivorans	2528964	S	6130	1715	7845	0.00041
Xanthobacter sp. YC-JY1	2419844	S	2095	1944	4039	0.00021
Xanthobacter autotrophicus	280	S	1955	1980	3935	0.00021
Azorhizobium caulinodans	7	S	4600	705	5305	0.00028
Rhodoplanes sp. Z2-YC6860	674703	S	86431	5645	92076	0.00482
Hyphomicrobium denitrificans	53399	S	21139	1476	22615	0.00118
Hyphomicrobium sp. MC1	717785	S	8412	362	8774	0.00046
Hyphomicrobium nitrativorans	1427356	S	3560	208	3768	0.00020
Methyloceanibacter sp. wino2	2170729	S	2323	522	2845	0.00015
Methyloceanibacter caenitepidi	1384459	S	2297	483	2780	0.00015
Aquabacter sp. L1I39	2820278	S	3862	429	4291	0.00022
Methyloligella sp. GL2	2742204	S	3469	288	3757	0.00020
Rhodomicrobium vannielii	1069	S	2541	122	2663	0.00014
Caenibius sp. WL	2872646	S	1299	199	1498	0.00008
Caenibius tardaugens	169176	S	1136	704	1840	0.00010
Candidatus Filomicrobium marinum	1608628	S	1103	21	1124	0.00006
Bosea sp. AS-1	2015316	S	81404	13570	94974	0.00497
Bosea sp. ANAM02	2020412	S	12630	2429	15059	0.00079
Bosea sp. F3-2	2599640	S	10517	1793	12310	0.00064
Bosea sp. Tri-49	1867715	S	7416	979	8395	0.00044
Bosea sp. RAC05	1842539	S	6383	1168	7551	0.00040
Bosea sp. PAMC 26642	1792307	S	4894	585	5479	0.00029
Bosea vaviloviae	1526658	S	6058	876	6934	0.00036
Devosia sp. A16	1736675	S	7802	736	8538	0.00045
Devosia sp. JXJ CY 41	2917991	S	3006	524	3530	0.00018
Devosia sp. SL43	2806348	S	2582	453	3035	0.00016
Devosia sp. 1566	2499144	S	2244	214	2458	0.00013
Devosia sp. I507	2083786	S	1756	537	2293	0.00012
Devosia ginsengisoli	400770	S	2983	504	3487	0.00018
Devosia beringensis	2657486	S	2887	385	3272	0.00017
Devosia oryziradicis	2801335	S	2385	413	2798	0.00015
Devosia salina	2860336	S	2296	761	3057	0.00016
Devosia rhizoryzae	2774137	S	1849	168	2017	0.00011
Paradevosia shaoguanensis	1335043	S	3158	942	4100	0.00021
Youhaiella tibetensis	1447062	S	3102	576	3678	0.00019
Pelagibacterium halotolerans	531813	S	1529	128	1657	0.00009
Aureimonas sp. AU20	1349819	S	3868	385	4253	0.00022
Aureimonas sp. SA4125	2826993	S	3858	497	4355	0.00023
Aureimonas sp. OT7	2816454	S	1817	1139	2956	0.00015
Aureimonas populi	1701758	S	3068	422	3490	0.00018
Aureimonas mangrovi	2758041	S	2813	422	3235	0.00017
Aureimonas altamirensis	370622	S	1714	459	2173	0.00011
Martelella sp. AD-3	686597	S	1181	3118	4299	0.00023
Martelella mediterranea	293089	S	2146	586	2732	0.00014
Martelella endophytica	1486262	S	1829	284	2113	0.00011
Martelella lutilitoris	2583532	S	1072	775	1847	0.00010
Aurantimonas sp. HBX-1	2906072	S	4727	976	5703	0.00030
Nordella sp. HKS 07	2712222	S	11947	452	12399	0.00065
Pseudorhodoplanes sinuspersici	1235591	S	10287	507	10794	0.00057
Terrihabitans soli	708113	S	3134	238	3372	0.00018
Methylocystis parvus	134	S	3044	272	3316	0.00017
Methylocystis bryophila	655015	S	3004	225	3229	0.00017
Methylocystis heyeri	391905	S	2702	228	2930	0.00015
Methylocystis sp. SC2	187303	S	1758	559	2317	0.00012
Methylocystis rosea	173366	S	1888	2036	3924	0.00021
Methylosinus trichosporium	426	S	4155	640	4795	0.00025
Methylosinus sp. C49	2699395	S	3387	508	3895	0.00020
Phreatobacter stygius	1940610	S	8180	880	9060	0.00047
Phreatobacter cathodiphilus	1868589	S	5947	1276	7223	0.00038
Phreatobacter sp. NMCR1094	2570229	S	4575	633	5208	0.00027
Stappia indica	538381	S	4725	823	5548	0.00029
Stappia sp. ES.058	1881061	S	2400	227	2627	0.00014
Roseibium aggregatum	187304	S	2850	325	3175	0.00017
Pannonibacter phragmitetus	121719	S	3483	1690	5173	0.00027
Labrenzia sp. VG12	2021862	S	1426	150	1576	0.00008
Methylocella silvestris	199596	S	2905	262	3167	0.00017
Methylocella tundrae	227605	S	2618	204	2822	0.00015
Methylovirgula ligni	569860	S	2598	223	2821	0.00015
Methylovirgula sp. HY1	2822761	S	1963	89	2052	0.00011
Beijerinckia indica	533	S	1336	82	1418	0.00007
Blastochloris tepida	2233851	S	5690	1398	7088	0.00037
Blastochloris viridis	1079	S	5019	1016	6035	0.00032
Kaustia mangrovi	2593653	S	5570	385	5955	0.00031
Parvibaculum lavamentivorans	256618	S	2661	1446	4107	0.00022
Pyruvatibacter mobilis	1712261	S	1775	180	1955	0.00010
Chelatococcus sp. CO-6	1702325	S	4940	2467	7407	0.00039
Chelatococcus daeguensis	444444	S	2745	1431	4176	0.00022
Kaistia sp. 32K	2795690	S	7435	1271	8706	0.00046
Brucella anthropi	529	S	1559	2389	3948	0.00021
Acuticoccus sp. I52.16.1	2928472	S	6585	523	7108	0.00037
Lichenihabitans psoromatis	2528642	S	1444	724	2168	0.00011
Lichenihabitans sp. PAMC28606	2880932	S	1281	747	2028	0.00011
Hartmannibacter diazotrophicus	1482074	S	3921	479	4400	0.00023
Breoghania sp. L-A4	2304600	S	3635	338	3973	0.00021
Sphingomonas sp. DM2-R-LB4	2899123	S	5302	1381	6683	0.00035
Sphingomonas sp. CL5.1	2653203	S	4523	1131	5654	0.00030
Sphingomonas sp. S8-45	2938948	S	4120	377	4497	0.00024
Sphingomonas sp. AK-PDB1-5	2872652	S	4105	493	4598	0.00024
Sphingomonas sp. MM-1	745310	S	3828	3692	7520	0.00039
Sphingomonas sp. AP4-R1	2735134	S	3775	363	4138	0.00022
Sphingomonas sp. Cra20	1327635	S	3523	405	3928	0.00021
Sphingomonas sp. AAP5	1523415	S	3411	653	4064	0.00021
Sphingomonas sp. LM7	1938607	S	3350	532	3882	0.00020
Sphingomonas sp. NBWT7	2596913	S	3037	755	3792	0.00020
Sphingomonas sp. HDW15A	2714942	S	2953	184	3137	0.00016
Sphingomonas sp. FARSPH	2219696	S	2946	1760	4706	0.00025
Sphingomonas sp. S2-65	2903960	S	2715	407	3122	0.00016
Sphingomonas sp. PAMC26645	2565555	S	2608	622	3230	0.00017
Sphingomonas sp. HMP9	1517554	S	2309	735	3044	0.00016
Sphingomonas sp. KC8	1030157	S	2116	206	2322	0.00012
Sphingomonas sp. HMP6	1517551	S	1949	278	2227	0.00012
Sphingomonas sp. LK11	1390395	S	1540	1042	2582	0.00014
Sphingomonas sp. NIC1	1961362	S	1383	2837	4220	0.00022
Sphingomonas lutea	1045317	S	9469	929	10398	0.00054
Sphingomonas sediminicola	386874	S	7197	513	7710	0.00040
Sphingomonas daechungensis	1176646	S	7100	509	7609	0.00040
Sphingomonas ginsengisoli An et al. 2013	363835	S	6089	624	6713	0.00035
Sphingomonas sabuli	2764186	S	5767	542	6309	0.00033
Sphingomonas alpina	653931	S	5551	337	5888	0.00031
Sphingomonas sinipercae	2714944	S	5508	563	6071	0.00032
Sphingomonas sanxanigenens	397260	S	5202	1792	6994	0.00037
Sphingomonas profundi	2681549	S	4910	580	5490	0.00029
Sphingomonas panacis	1560345	S	4811	519	5330	0.00028
Sphingomonas rhizophila	2071607	S	4142	730	4872	0.00026
Sphingomonas piscis	2714943	S	4076	288	4364	0.00023
Sphingomonas taxi	1549858	S	3720	822	4542	0.00024
Sphingomonas hengshuiensis	1609977	S	3670	344	4014	0.00021
Sphingomonas panacisoli	1813879	S	3330	329	3659	0.00019
Sphingomonas koreensis	93064	S	3109	1610	4719	0.00025
Sphingomonas changnyeongensis	2698679	S	2868	426	3294	0.00017
Sphingomonas xanthus	2594473	S	2817	428	3245	0.00017
Sphingomonas radiodurans	2890321	S	2552	249	2801	0.00015
Sphingomonas paucimobilis	13689	S	2506	1111	3617	0.00019
Sphingomonas suaedae	2599297	S	2482	232	2714	0.00014
Sphingomonas insulae	424800	S	2413	487	2900	0.00015
Sphingomonas aliaeris	2759526	S	2229	207	2436	0.00013
Sphingomonas sanguinis	33051	S	1784	1051	2835	0.00015
Sphingomonas melonis	152682	S	1609	4904	6513	0.00034
Sphingobium sp. TKS	1315974	S	17788	20733	38521	0.00202
Sphingobium sp. YG1	2082188	S	7869	2636	10505	0.00055
Sphingobium sp. CAP-1	2676077	S	3454	1686	5140	0.00027
Sphingobium sp. SYK-6	627192	S	2724	565	3289	0.00017
Sphingobium sp. KCTC 72723	2733867	S	2483	373	2856	0.00015
Sphingobium sp. EP60837	1855519	S	2266	556	2822	0.00015
Sphingobium sp. RAC03	1843368	S	2236	352	2588	0.00014
Sphingobium sp. Cam5-1	2789327	S	1801	642	2443	0.00013
Sphingobium sp. MI1205	407020	S	1587	1887	3474	0.00018
Sphingobium sp. SCG-1	2072936	S	1541	97	1638	0.00009
Sphingobium yanoikuyae	13690	S	5165	8101	13266	0.00069
Sphingobium indicum	332055	S	4154	2634	6788	0.00036
Sphingobium chlorophenolicum	46429	S	3946	1393	5339	0.00028
Sphingobium amiense	135719	S	2525	2391	4916	0.00026
Sphingobium xenophagum	121428	S	2283	1138	3421	0.00018
Sphingobium cloacae	120107	S	2170	2398	4568	0.00024
Sphingobium phenoxybenzoativorans	1592790	S	1956	617	2573	0.00013
Sphingobium fuliginis	336203	S	1844	6367	8211	0.00043
Sphingobium baderi	1332080	S	1739	1356	3095	0.00016
Sphingobium herbicidovorans	76947	S	1436	987	2423	0.00013
Novosphingobium sp. Sx8-5	2896849	S	5579	669	6248	0.00033
Novosphingobium sp. P6W	1609758	S	3990	555	4545	0.00024
Novosphingobium sp. EMRT-2	2571749	S	3950	1789	5739	0.00030
Novosphingobium sp. Gsoil 351	2675225	S	3753	262	4015	0.00021
Novosphingobium sp. ES2-1	2780074	S	2819	1282	4101	0.00021
Novosphingobium sp. THN1	1016987	S	2319	742	3061	0.00016
Novosphingobium sp. PP1Y	702113	S	1421	1634	3055	0.00016
Novosphingobium sp. KA1	164608	S	1193	4195	5388	0.00028
Novosphingobium resinovorum	158500	S	6967	2659	9626	0.00050
Novosphingobium decolorationis	2698673	S	3024	1269	4293	0.00022
Novosphingobium aromaticivorans	48935	S	2988	1124	4112	0.00022
Novosphingobium ginsenosidimutans	1176536	S	2789	233	3022	0.00016
Novosphingobium pentaromativorans	205844	S	1462	2331	3793	0.00020
Sphingopyxis sp. OPL5	2486273	S	3342	532	3874	0.00020
Sphingopyxis sp. QXT-31	1357916	S	2819	656	3475	0.00018
Sphingopyxis sp. YF1	2482763	S	2816	535	3351	0.00018
Sphingopyxis sp. 113P3	292913	S	2324	694	3018	0.00016
Sphingopyxis sp. BSN-002	2911495	S	2267	339	2606	0.00014
Sphingopyxis sp. PAMC25046	2565556	S	2214	864	3078	0.00016
Sphingopyxis sp. FD7	1914525	S	1968	675	2643	0.00014
Sphingopyxis sp. EG6	1874061	S	1726	740	2466	0.00013
Sphingopyxis macrogoltabida	33050	S	5145	2086	7231	0.00038
Sphingopyxis terrae	33052	S	2502	1162	3664	0.00019
Sphingopyxis lindanitolerans	2054227	S	2429	929	3358	0.00018
Sphingopyxis fribergensis	1515612	S	2165	721	2886	0.00015
Sphingopyxis granuli	267128	S	1947	4954	6901	0.00036
Sphingopyxis alaskensis	117207	S	1551	309	1860	0.00010
Rhizorhabdus wittichii	160791	S	7018	3134	10152	0.00053
Rhizorhabdus dicambivorans	1850238	S	4138	2498	6636	0.00035
Rhizorhabdus phycosphaerae	2711156	S	2859	280	3139	0.00016
Sphingosinithalassobacter sp. CS137	2762748	S	2616	420	3036	0.00016
Sphingosinithalassobacter tenebrarum	2711215	S	2368	574	2942	0.00015
Allosphingosinicella indica	941907	S	3474	337	3811	0.00020
Parasphingopyxis algicola	2026624	S	2252	137	2389	0.00013
Tardibacter chloracetimidivorans	1921510	S	2277	1309	3586	0.00019
Hankyongella ginsenosidimutans	1763828	S	2015	299	2314	0.00012
Citromicrobium sp. JL477	1634516	S	1641	595	2236	0.00012
Novosphingopyxis iocasae	2762729	S	1254	553	1807	0.00009
Erythrobacter sp. HL-111	1798193	S	2218	700	2918	0.00015
Erythrobacter sp. JK5	2829500	S	1576	708	2284	0.00012
Erythrobacter sp. HKB08	2502843	S	1544	511	2055	0.00011
Erythrobacter sp. SDW2	2907154	S	1379	493	1872	0.00010
Erythrobacter litoralis	39960	S	2803	1025	3828	0.00020
Erythrobacter neustonensis	1112	S	1369	271	1640	0.00009
Erythrobacter mangrovi	2739433	S	1104	355	1459	0.00008
Porphyrobacter sp. CACIAM 03H1	2003315	S	2419	592	3011	0.00016
Porphyrobacter sp. LM 6	1896196	S	1318	382	1700	0.00009
Porphyrobacter sp. HT-58-2	2023229	S	1251	249	1500	0.00008
Porphyrobacter sp. GA68	2883480	S	1095	412	1507	0.00008
Qipengyuania flava	192812	S	3258	1958	5216	0.00027
Qipengyuania sediminis	1532023	S	1620	224	1844	0.00010
Qipengyuania soli	2782568	S	1209	308	1517	0.00008
Qipengyuania aurantiaca	2867233	S	1128	720	1848	0.00010
Croceicoccus sp. YJ47	2798724	S	1626	1260	2886	0.00015
Croceicoccus marinus	450378	S	2909	1502	4411	0.00023
Croceicoccus naphthovorans	1348774	S	1282	1295	2577	0.00014
Altererythrobacter sp. B11	2060312	S	2058	931	2989	0.00016
Altererythrobacter sp. TH136	2067415	S	1636	276	1912	0.00010
Tsuneonella amylolytica	2338327	S	2183	550	2733	0.00014
Tsuneonella dongtanensis	692370	S	1971	343	2314	0.00012
Tsuneonella mangrovi	1982042	S	1454	196	1650	0.00009
Pelagerythrobacter marensis	543877	S	1347	172	1519	0.00008
Paraurantiacibacter namhicola	645517	S	1150	134	1284	0.00007
Croceibacterium atlanticum	1267766	S	1032	443	1475	0.00008
Sphingosinicella sp. BN140058	1892855	S	4801	352	5153	0.00027
Sphingosinicella microcystinivorans	335406	S	2390	243	2633	0.00014
Sphingosinicella flava	2771430	S	1865	213	2078	0.00011
Polymorphobacter sp. PAMC 29362	2835787	S	1861	1179	3040	0.00016
Polymorphobacter sp. PAMC 29334	2862331	S	1655	1081	2736	0.00014
Sandaracinobacter sp. M6	2759707	S	2231	126	2357	0.00012
Azospirillum sp. B510	137722	S	3671	1089	4760	0.00025
Azospirillum sp. TSH100	652764	S	3043	1115	4158	0.00022
Azospirillum sp. TSA2s	709810	S	2867	1737	4604	0.00024
Azospirillum sp. TSH58	664962	S	2094	2197	4291	0.00022
Azospirillum brasilense	192	S	11573	7983	19556	0.00102
Azospirillum thermophilum	2202148	S	6888	1218	8106	0.00042
Azospirillum thiophilum	528244	S	4501	1149	5650	0.00030
Azospirillum ramasamyi	682998	S	2585	1168	3753	0.00020
Azospirillum humicireducens	1226968	S	2307	1060	3367	0.00018
Azospirillum lipoferum	193	S	2224	1291	3515	0.00018
Azospirillum oryzae	286727	S	2147	1463	3610	0.00019
Azospirillum baldaniorum	1064539	S	1439	2305	3744	0.00020
Skermanella mucosa	1789672	S	4708	2804	7512	0.00039
Skermanella sp. TT6	2775420	S	4431	3795	8226	0.00043
Skermanella rosea	1817965	S	4009	3152	7161	0.00038
Skermanella pratensis	2233999	S	3827	1802	5629	0.00029
Nitrospirillum amazonense	28077	S	4924	442	5366	0.00028
Indioceanicola profundi	2220096	S	3429	364	3793	0.00020
Niveispirillum cyanobacteriorum	1612173	S	1975	165	2140	0.00011
Roseomonas sp. OT10	2897332	S	7536	1679	9215	0.00048
Roseomonas sp. S08	1750527	S	7135	370	7505	0.00039
Roseomonas gilardii	257708	S	6091	6366	12457	0.00065
Roseomonas haemaphysalidis	2768162	S	5235	579	5814	0.00030
Roseomonas marmotae	2768161	S	4528	523	5051	0.00026
Rhodovastum atsumiense	504468	S	8864	739	9603	0.00050
Komagataeibacter xylinus	28448	S	1739	3322	5061	0.00027
Acidiphilium multivorum	62140	S	1367	5609	6976	0.00037
Roseococcus microcysteis	2771361	S	4551	337	4888	0.00026
Sediminicoccus rosea	1225128	S	3857	158	4015	0.00021
Lichenicola cladoniae	1484109	S	3845	149	3994	0.00021
Acidibrevibacterium fodinaquatile	1969806	S	3621	252	3873	0.00020
Acetobacter aceti	435	S	1324	933	2257	0.00012
Gluconacetobacter diazotrophicus	33996	S	2364	414	2778	0.00015
Granulibacter bethesdensis	364410	S	1646	5748	7394	0.00039
Hypericibacter adhaerens	2602016	S	9196	1279	10475	0.00055
Hypericibacter terrae	2602015	S	8824	974	9798	0.00051
Magnetospirillum sp. XM-1	1663591	S	2184	615	2799	0.00015
Magnetospirillum sp. ME-1	1639348	S	1972	603	2575	0.00013
Magnetospirillum gryphiswaldense	55518	S	2576	182040	184616	0.00967
Magnetospirillum magneticum	84159	S	2158	182	2340	0.00012
Rhodospirillum centenum	34018	S	4224	463	4687	0.00025
Rhodospirillum rubrum	1085	S	2493	146	2639	0.00014
Tistrella mobilis	171437	S	5005	1796	6801	0.00036
Ferrovibrio terrae	2594003	S	3516	174	3690	0.00019
Defluviicoccus vanus	111831	S	2616	182	2798	0.00015
Pararhodospirillum photometricum	1084	S	1530	93	1623	0.00009
Stella humosa	94	S	9701	527	10228	0.00054
Elioraea tepida	2843330	S	4823	193	5016	0.00026
Paracoccus sp. MC1862	2760307	S	1786	165	1951	0.00010
Paracoccus sp. MA	2895796	S	1733	970	2703	0.00014
Paracoccus sp. AK26	2589076	S	1237	197	1434	0.00008
Paracoccus sanguinis	1545044	S	2767	635	3402	0.00018
Paracoccus yeei	147645	S	2310	3832	6142	0.00032
Paracoccus denitrificans	266	S	2078	965	3043	0.00016
Paracoccus liaowanqingii	2560053	S	2043	205	2248	0.00012
Paracoccus aminovorans	34004	S	1875	480	2355	0.00012
Paracoccus pantotrophus	82367	S	1817	1054	2871	0.00015
Paracoccus zhejiangensis	1077935	S	1816	379	2195	0.00011
Paracoccus suum	2259340	S	1562	237	1799	0.00009
Paracoccus aminophilus	34003	S	1533	122	1655	0.00009
Paracoccus jeotgali	2065379	S	1527	247	1774	0.00009
Paracoccus contaminans	1945662	S	1512	310	1822	0.00010
Cereibacter sphaeroides	1063	S	6316	4403	10719	0.00056
Rhodobacter sp. CZR27	2033869	S	2474	586	3060	0.00016
Rhodobacter sp. LPB0142	1850250	S	2011	1138	3149	0.00016
Rhodobacter sp. N10	2807096	S	1968	182	2150	0.00011
Rhodobacter capsulatus	1061	S	2692	422	3114	0.00016
Rhodovulum sp. P5	1564506	S	1428	129	1557	0.00008
Rhodovulum sp. MB263	308754	S	1263	386	1649	0.00009
Rhodovulum sulfidophilum	35806	S	2153	1074	3227	0.00017
Polymorphum gilvum	991904	S	4093	782	4875	0.00026
Paroceanicella profunda	2579971	S	4000	887	4887	0.00026
Thioclava electrotropha	1549850	S	1331	280	1611	0.00008
Thioclava nitratireducens	1915078	S	1204	345	1549	0.00008
Pikeienuella piscinae	2748098	S	2669	199	2868	0.00015
Pontivivens ytuae	2789856	S	2498	153	2651	0.00014
Pelagovum pacificum	2588711	S	2288	231	2519	0.00013
Silicimonas algicola	1826607	S	2087	100	2187	0.00011
Pukyongiella litopenaei	2605946	S	1932	396	2328	0.00012
Frigidibacter mobilis	1335048	S	1909	646	2555	0.00013
Brevirhabdus pacifica	1267768	S	1608	661	2269	0.00012
Fuscovulum blasticum	1075	S	1344	132	1476	0.00008
Gymnodinialimonas ceratoperidinii	2856823	S	1343	106	1449	0.00008
Haematobacter massiliensis	195105	S	1293	404	1697	0.00009
Pacificitalea manganoxidans	1411902	S	1262	236	1498	0.00008
Pseudopuniceibacterium antarcticum	2613965	S	1253	81	1334	0.00007
Falsirhodobacter sp. PG104	2692330	S	1225	139	1364	0.00007
Gemmobacter aquarius	2169400	S	1118	187	1305	0.00007
Tabrizicola piscis	2494374	S	1099	77	1176	0.00006
Pseudooceanicola algae	1537215	S	1009	81	1090	0.00006
Roseovarius sp. SCSIO 43702	2823043	S	1818	1266	3084	0.00016
Roseovarius indicus	540747	S	2401	1148	3549	0.00019
Roseovarius faecimaris	2494550	S	1006	103	1109	0.00006
Sulfitobacter sp. JK7-1	2829501	S	1056	124	1180	0.00006
Sulfitobacter sp. THAF37	2587855	S	1004	928	1932	0.00010
Sulfitobacter alexandrii	1917485	S	1501	1093	2594	0.00014
Salipiger profundus	1229727	S	2926	1118	4044	0.00021
Salipiger abyssi	1250539	S	2243	757	3000	0.00016
Salipiger sp. CCB-MM3	1792508	S	1982	238	2220	0.00012
Roseivivax sp. THAF30	2587852	S	1372	1436	2808	0.00015
Roseivivax marinus	1379903	S	2720	377	3097	0.00016
Celeribacter indicus	1208324	S	2300	967	3267	0.00017
Phaeobacter gallaeciensis	60890	S	1100	962	2062	0.00011
Leisingera aquaemixtae	1396826	S	1185	321	1506	0.00008
Ruegeria pomeroyi	89184	S	1350	220	1570	0.00008
Sulfitobacter pseudonitzschiae	1402135	S	1815	601	2416	0.00013
Yangia pacifica	311180	S	2430	353	2783	0.00015
Sagittula sp. P11	2009329	S	2387	866	3253	0.00017
Mameliella alba	561184	S	1785	291	2076	0.00011
Ponticoccus alexandrii	1943633	S	1764	228	1992	0.00010
Dinoroseobacter shibae	215813	S	1624	525	2149	0.00011
Actibacterium sp. EMB200-NS6	1609966	S	1376	590	1966	0.00010
Roseibacterium elongatum	159346	S	1274	92	1366	0.00007
Oceanicola sp. D3	2587163	S	1173	51	1224	0.00006
Caulobacter sp. S6	2823693	S	7496	668	8164	0.00043
Caulobacter sp. FWC26	69665	S	2577	968	3545	0.00019
Caulobacter segnis	88688	S	8936	2984	11920	0.00062
Caulobacter mirabilis	69666	S	6263	962	7225	0.00038
Caulobacter rhizosphaerae	2010972	S	5565	1391	6956	0.00036
Caulobacter flavus	1679497	S	5511	1308	6819	0.00036
Caulobacter vibrioides	155892	S	5447	1939	7386	0.00039
Caulobacter soli	2708539	S	5028	1374	6402	0.00034
Caulobacter henricii	69395	S	2189	315	2504	0.00013
Brevundimonas sp. LM2	1938605	S	2008	710	2718	0.00014
Brevundimonas sp. PAMC22021	2861285	S	1916	1079	2995	0.00016
Brevundimonas sp. M20	2591463	S	1853	405	2258	0.00012
Brevundimonas sp. MF30-B	2561924	S	1671	476	2147	0.00011
Brevundimonas sp. AJA228-03	2752515	S	1343	392	1735	0.00009
Brevundimonas naejangsanensis	588932	S	3385	1280	4665	0.00024
Brevundimonas goettingensis	2774190	S	2359	357	2716	0.00014
Brevundimonas albigilva	1312364	S	2323	1236	3559	0.00019
Brevundimonas subvibrioides	74313	S	1868	338	2206	0.00012
Brevundimonas diminuta	293	S	1557	3832	5389	0.00028
Brevundimonas pondensis	2774189	S	1510	482	1992	0.00010
Brevundimonas mediterranea	74329	S	1362	620	1982	0.00010
Brevundimonas vitisensis	2800818	S	1328	153	1481	0.00008
Brevundimonas nasdae	172043	S	1239	742	1981	0.00010
Phenylobacterium zucineum	284016	S	14302	2403	16705	0.00088
Phenylobacterium parvum	2201350	S	3901	364	4265	0.00022
Asticcacaulis excentricus	78587	S	1637	209	1846	0.00010
Asticcacaulis sp. AND118	2840468	S	1421	176	1597	0.00008
Terricaulis silvestris	2686094	S	2396	64	2460	0.00013
Marinicauda algicola	2029849	S	3041	400	3441	0.00018
Maricaulis maris	74318	S	1004	52	1056	0.00006
Hyphomonas sp. CACIAM 19H1	1873716	S	1086	134	1220	0.00006
Hyphomonas neptunium	81032	S	1012	90	1102	0.00006
Candidatus Viadribacter manganicus	1759059	S	1391	28	1419	0.00007
Aquisalinus flavus	1526572	S	1256	46	1302	0.00007
Burkholderia cenocepacia	95486	S	12683	46802	59485	0.00312
Burkholderia multivorans	87883	S	9092	15294	24386	0.00128
Burkholderia ubonensis	101571	S	8765	5132	13897	0.00073
Burkholderia cepacia	292	S	6977	12040	19017	0.00100
Burkholderia pyrrocinia	60550	S	4324	2414	6738	0.00035
Burkholderia anthina	179879	S	4291	3910	8201	0.00043
Burkholderia contaminans	488447	S	3739	2198	5937	0.00031
Burkholderia ambifaria	152480	S	3692	4365	8057	0.00042
Burkholderia stabilis	95485	S	3061	2047	5108	0.00027
Burkholderia stagnalis	1503054	S	2998	938	3936	0.00021
Burkholderia lata	482957	S	2862	2392	5254	0.00028
Burkholderia dolosa	152500	S	2384	7063	9447	0.00049
Burkholderia territorii	1503055	S	2119	1012	3131	0.00016
Burkholderia seminalis	488731	S	2008	901	2909	0.00015
Burkholderia vietnamiensis	60552	S	1725	5104	6829	0.00036
Burkholderia metallica	488729	S	1562	717	2279	0.00012
Burkholderia diffusa	488732	S	1099	537	1636	0.00009
Burkholderia sp. DHOD12	2571746	S	4289	401	4690	0.00025
Burkholderia sp. Bp7605	1740163	S	2317	290	2607	0.00014
Burkholderia sp. LAS2	2813843	S	2003	13565	15568	0.00082
Burkholderia sp. NRF60-BP8	1637853	S	1346	799	2145	0.00011
Burkholderia sp. LA-2-3-30-S1-D2	1637862	S	1054	812	1866	0.00010
Burkholderia sp. MSMB0856	1637869	S	1039	880	1919	0.00010
Burkholderia pseudomallei	28450	S	3967	26867	30834	0.00162
Burkholderia mayonis	1385591	S	2767	570	3337	0.00017
Burkholderia thailandensis	57975	S	2640	6037	8677	0.00045
Burkholderia oklahomensis	342113	S	1858	1569	3427	0.00018
Burkholderia gladioli	28095	S	10435	3081	13516	0.00071
Burkholderia glumae	337	S	3691	1404	5095	0.00027
Burkholderia plantarii	41899	S	3034	1131	4165	0.00022
Burkholderia perseverans	2615214	S	2484	1004	3488	0.00018
Cupriavidus pauculus	82633	S	22882	8484	31366	0.00164
Cupriavidus campinensis	151783	S	19902	6443	26345	0.00138
Cupriavidus taiwanensis	164546	S	17177	13975	31152	0.00163
Cupriavidus basilensis	68895	S	13952	6242	20194	0.00106
Cupriavidus pinatubonensis	248026	S	11194	1670	12864	0.00067
Cupriavidus necator	106590	S	8123	7977	16100	0.00084
Cupriavidus sp. EM10	2839983	S	4430	2476	6906	0.00036
Cupriavidus sp. MP-37	2884455	S	1441	1614	3055	0.00016
Cupriavidus oxalaticus	96344	S	7674	3031	10705	0.00056
Cupriavidus metallidurans	119219	S	4979	18266	23245	0.00122
Cupriavidus neocaledonicus	1040979	S	1412	1785	3197	0.00017
Cupriavidus gilardii	82541	S	1310	6698	8008	0.00042
Cupriavidus nantongensis	1796606	S	1143	2721	3864	0.00020
Paraburkholderia graminis	60548	S	24503	4560	29063	0.00152
Paraburkholderia caledonica	134536	S	11659	1616	13275	0.00070
Paraburkholderia sp. SOS3	1926494	S	3441	391	3832	0.00020
Paraburkholderia sp. PGU16	2735433	S	3049	1231	4280	0.00022
Paraburkholderia sp. PGU19	2735434	S	1971	1215	3186	0.00017
Paraburkholderia aromaticivorans	2026199	S	7174	2346	9520	0.00050
Paraburkholderia caribensis	75105	S	6475	3328	9803	0.00051
Paraburkholderia phymatum	148447	S	5192	984	6176	0.00032
Paraburkholderia edwinii	2861782	S	4889	519	5408	0.00028
Paraburkholderia pallida	2547399	S	4668	668	5336	0.00028
Paraburkholderia acidisoli	2571748	S	4232	606	4838	0.00025
Paraburkholderia phytofirmans	261302	S	4150	1379	5529	0.00029
Paraburkholderia tropica	92647	S	3997	707	4704	0.00025
Paraburkholderia atlantica	2654982	S	3624	678	4302	0.00023
Paraburkholderia terricola	169427	S	3521	807	4328	0.00023
Paraburkholderia acidiphila	2571747	S	3512	546	4058	0.00021
Paraburkholderia sprentiae	948107	S	3175	533	3708	0.00019
Paraburkholderia terrae	311230	S	3103	2507	5610	0.00029
Paraburkholderia phenoliruptrix	252970	S	3018	646	3664	0.00019
Paraburkholderia fungorum	134537	S	2887	508	3395	0.00018
Paraburkholderia hospita	169430	S	2726	2206	4932	0.00026
Paraburkholderia ginsengisoli	311231	S	2681	621	3302	0.00017
Paraburkholderia megapolitana	420953	S	2676	207	2883	0.00015
Paraburkholderia xenovorans	36873	S	2459	2410	4869	0.00026
Paraburkholderia caffeinilytica	1761016	S	2250	438	2688	0.00014
Paraburkholderia dioscoreae	2604047	S	2019	965	2984	0.00016
Paraburkholderia dokdonella	2211211	S	1741	364	2105	0.00011
Caballeronia zhejiangensis	871203	S	40395	6351	46746	0.00245
Caballeronia sp. Lep1P3	2878150	S	7334	1338	8672	0.00045
Caballeronia sp. TF1N1	2878153	S	6104	560	6664	0.00035
Caballeronia sp. SL2Y3	2878151	S	2760	2170	4930	0.00026
Caballeronia sp. Sq4a	2878152	S	2740	2995	5735	0.00030
Caballeronia sp. M1242	2814653	S	2294	2475	4769	0.00025
Caballeronia grimmiae	1071679	S	23328	8862	32190	0.00169
Caballeronia insecticola	758793	S	13106	1868	14974	0.00078
Ralstonia sp. 56D2	2842456	S	23658	3173	26831	0.00141
Ralstonia solanacearum	305	S	9517	18441	27958	0.00146
Ralstonia pickettii	329	S	6694	2715	9409	0.00049
Ralstonia insidiosa	190721	S	3798	2315	6113	0.00032
Ralstonia mannitolilytica	105219	S	2604	2615	5219	0.00027
Pandoraea pnomenusa	93220	S	3230	1333	4563	0.00024
Pandoraea thiooxydans	445709	S	2389	164	2553	0.00013
Pandoraea sp. XY-2	2518599	S	2387	1036	3423	0.00018
Pandoraea pulmonicola	93221	S	2356	433	2789	0.00015
Pandoraea norimbergensis	93219	S	1777	237	2014	0.00011
Pandoraea vervacti	656178	S	1757	431	2188	0.00011
Pandoraea faecigallinarum	656179	S	1694	384	2078	0.00011
Pandoraea apista	93218	S	1529	700	2229	0.00012
Pandoraea fibrosis	1891094	S	1391	388	1779	0.00009
Pandoraea oxalativorans	573737	S	1324	525	1849	0.00010
Pandoraea sputorum	93222	S	1190	442	1632	0.00009
Lautropia mirabilis	47671	S	1584	247	1831	0.00010
Chitinimonas arctica	2594795	S	1420	98	1518	0.00008
Mycetohabitans rhizoxinica	412963	S	1211	71	1282	0.00007
Variovorax sp. HW608	1034889	S	9536	1494	11030	0.00058
Variovorax sp. PBS-H4	434008	S	7747	4629	12376	0.00065
Variovorax sp. RA8	662548	S	4737	3843	8580	0.00045
Variovorax sp. PBL-H6	434009	S	4659	5150	9809	0.00051
Variovorax sp. RKNM96	2681552	S	4614	1738	6352	0.00033
Variovorax sp. WDL1	207745	S	4510	6973	11483	0.00060
Variovorax sp. PAMC26660	2762322	S	4435	1108	5543	0.00029
Variovorax sp. PAMC 28711	1795631	S	3793	599	4392	0.00023
Variovorax sp. SRS16	282217	S	3449	10533	13982	0.00073
Variovorax sp. PAMC28562	2762323	S	2886	229	3115	0.00016
Variovorax sp. 38R	2774875	S	2573	3042	5615	0.00029
Variovorax sp. PBL-E5	434014	S	2303	8141	10444	0.00055
Variovorax paradoxus	34073	S	21124	16992	38116	0.00200
Variovorax boronicumulans	436515	S	3434	2375	5809	0.00030
Acidovorax sp. YS12	2738413	S	2704	2077	4781	0.00025
Acidovorax sp. KKS102	358220	S	2541	1633	4174	0.00022
Acidovorax sp. RAC01	1842533	S	1686	1227	2913	0.00015
Acidovorax sp. JMULE5	2518343	S	1609	411	2020	0.00011
Acidovorax sp. HDW3	2714923	S	1386	875	2261	0.00012
Acidovorax sp. 1608163	2478662	S	1200	233	1433	0.00008
Acidovorax sp. T1	1858609	S	1030	3320	4350	0.00023
Acidovorax avenae	80867	S	5866	3609	9475	0.00050
Acidovorax monticola	1926868	S	3027	1107	4134	0.00022
Acidovorax antarcticus	2743470	S	2985	2007	4992	0.00026
Acidovorax carolinensis	553814	S	1933	1462	3395	0.00018
Acidovorax citrulli	80869	S	1696	1509	3205	0.00017
Acidovorax cattleyae	80868	S	1401	950	2351	0.00012
Acidovorax radicis	758826	S	1233	235	1468	0.00008
Hydrogenophaga sp. BA0156	2716225	S	4293	2726	7019	0.00037
Hydrogenophaga sp. BPS33	2651974	S	3704	2580	6284	0.00033
Hydrogenophaga sp. YM1	2806262	S	3675	1699	5374	0.00028
Hydrogenophaga sp. PBC	795665	S	3477	3556	7033	0.00037
Hydrogenophaga sp. SL48	2806347	S	2969	661	3630	0.00019
Hydrogenophaga sp. PBL-H3	434010	S	2199	1788	3987	0.00021
Hydrogenophaga sp. RAC07	1842537	S	2165	680	2845	0.00015
Hydrogenophaga sp. PAMC20947	2565558	S	1108	67	1175	0.00006
Hydrogenophaga sp. NH-16	2184519	S	1038	2211	3249	0.00017
Hydrogenophaga taeniospiralis	65656	S	2501	695	3196	0.00017
Hydrogenophaga crassostreae	1763535	S	1139	65	1204	0.00006
Hydrogenophaga pseudoflava	47421	S	1119	1913	3032	0.00016
Rhodoferax koreense	1842727	S	17374	7923	25297	0.00133
Rhodoferax sp. BAB1	2741720	S	2670	658	3328	0.00017
Rhodoferax sp. AJA081-3	2752316	S	1017	62	1079	0.00006
Rhodoferax sediminis	2509614	S	3334	445	3779	0.00020
Rhodoferax ferrireducens	192843	S	1327	73	1400	0.00007
Rhodoferax saidenbachensis	1484693	S	1114	99	1213	0.00006
Comamonas sp. NLF-7-7	2597701	S	1840	1355	3195	0.00017
Comamonas sp. NLF-1-9	2853163	S	1611	910	2521	0.00013
Comamonas sp. B21-038	2918299	S	1136	350	1486	0.00008
Comamonas serinivorans	1082851	S	2622	658	3280	0.00017
Comamonas aquatica	225991	S	2556	2291	4847	0.00025
Comamonas testosteroni	285	S	1948	3451	5399	0.00028
Comamonas koreensis	160825	S	1148	734	1882	0.00010
Comamonas odontotermitis	379895	S	1057	196	1253	0.00007
Ramlibacter tataouinensis	94132	S	20435	7135	27570	0.00144
Schlegelella thermodepolymerans	215580	S	5634	2386	8020	0.00042
Schlegelella brevitalea	413882	S	5336	672	6008	0.00031
Diaphorobacter sp. HDW4A	2714924	S	1842	2008	3850	0.00020
Diaphorobacter sp. HDW4B	2714925	S	1775	733	2508	0.00013
Diaphorobacter ruginosibacter	1715720	S	2272	978	3250	0.00017
Diaphorobacter aerolatus	1288495	S	1741	3001	4742	0.00025
Delftia tsuruhatensis	180282	S	2331	6830	9161	0.00048
Delftia acidovorans	80866	S	2048	4233	6281	0.00033
Kinneretia sp. DAIF2	2714952	S	5969	1873	7842	0.00041
Kinneretia sp. XES5	2877940	S	2394	2541	4935	0.00026
Polaromonas sp. JS666	296591	S	2762	2725	5487	0.00029
Polaromonas naphthalenivorans	216465	S	2378	355	2733	0.00014
Ottowia sp. 27C	2816950	S	2505	436	2941	0.00015
Ottowia sp. oral taxon 894	1658672	S	1061	136	1197	0.00006
Ottowia oryzae	2109914	S	2003	395	2398	0.00013
Alicycliphilus denitrificans	179636	S	5249	8339	13588	0.00071
Melaminivora sp. SC2-9	2109913	S	2457	2530	4987	0.00026
Melaminivora jejuensis	1267217	S	1924	1317	3241	0.00017
Serpentinimonas maccroryi	1458426	S	1414	423	1837	0.00010
Serpentinimonas raichei	1458425	S	1180	388	1568	0.00008
Verminephrobacter eiseniae	364317	S	2524	277	2801	0.00015
Pulveribacter suum	2116657	S	2040	951	2991	0.00016
Hylemonella gracilis	80880	S	2022	259	2281	0.00012
Simplicispira suum	2109915	S	1545	517	2062	0.00011
Massilia sp. WG5	1707785	S	12551	7418	19969	0.00105
Massilia sp. HC52	2852099	S	5420	2607	8027	0.00042
Massilia sp. DM-R-R2A-13	2899220	S	4680	1773	6453	0.00034
Massilia sp. LPB0304	2769491	S	4193	2606	6799	0.00036
Massilia sp. YMA4	1593482	S	3485	2243	5728	0.00030
Massilia sp. NP310	2861282	S	3262	2650	5912	0.00031
Massilia sp. PAMC28688	2861283	S	2413	567	2980	0.00016
Massilia putida	1141883	S	10352	2892	13244	0.00069
Massilia violaceinigra	2045208	S	6169	1523	7692	0.00040
Massilia flava	871742	S	5453	1165	6618	0.00035
Massilia albidiflava	321983	S	3748	1297	5045	0.00026
Massilia lutea	321985	S	3725	992	4717	0.00025
Massilia umbonata	864828	S	3655	1275	4930	0.00026
Massilia armeniaca	2072590	S	3437	1570	5007	0.00026
Massilia plicata	321984	S	3256	744	4000	0.00021
Massilia antarctica	2765360	S	2824	919	3743	0.00020
Massilia oculi	945844	S	2764	1531	4295	0.00023
Duganella sp. GN2-R2	2728020	S	5484	1974	7458	0.00039
Duganella sp. AF9R3	2728021	S	3546	636	4182	0.00022
Herbaspirillum hiltneri	341045	S	6235	942	7177	0.00038
Herbaspirillum robiniae	2014887	S	3750	1221	4971	0.00026
Herbaspirillum frisingense	92645	S	3199	903	4102	0.00021
Herbaspirillum seropedicae	964	S	2901	1123	4024	0.00021
Herbaspirillum rubrisubalbicans	80842	S	2526	1032	3558	0.00019
Herbaspirillum huttiense	863372	S	1908	688	2596	0.00014
Herbaspirillum sp. meg3	2025949	S	1888	194	2082	0.00011
Janthinobacterium sp. 1_2014MBL_MicDiv	1644131	S	1809	1154	2963	0.00016
Janthinobacterium sp. 17J80-10	2497863	S	1609	212	1821	0.00010
Janthinobacterium agaricidamnosum	55508	S	2726	5797	8523	0.00045
Collimonas fungivorans	158899	S	2669	661	3330	0.00017
Collimonas arenae	279058	S	2059	239	2298	0.00012
Collimonas pratensis	279113	S	1858	345	2203	0.00012
Noviherbaspirillum sp. UKPF54	2601898	S	3709	554	4263	0.00022
Achromobacter xylosoxidans	85698	S	9624	16953	26577	0.00139
Achromobacter sp. AONIH1	1758194	S	3231	4131	7362	0.00039
Achromobacter sp. MFA1 R4	1881016	S	2375	1612	3987	0.00021
Achromobacter spanius	217203	S	4938	2009	6947	0.00036
Achromobacter denitrificans	32002	S	4355	3448	7803	0.00041
Achromobacter deleyi	1353891	S	3324	2586	5910	0.00031
Achromobacter insolitus	217204	S	2328	695	3023	0.00016
Achromobacter pestifer	1353889	S	1751	1246	2997	0.00016
Bordetella sp. H567	1697043	S	3218	363	3581	0.00019
Bordetella sp. N	1746199	S	3040	324	3364	0.00018
Bordetella bronchialis	463025	S	3715	471	4186	0.00022
Bordetella genomosp. 8	1416806	S	3449	393	3842	0.00020
Bordetella genomosp. 13	463040	S	3281	2053	5334	0.00028
Bordetella genomosp. 9	1416803	S	2902	664	3566	0.00019
Bordetella flabilis	463014	S	2885	227	3112	0.00016
Bordetella hinzii	103855	S	2528	1054	3582	0.00019
Bordetella petrii	94624	S	2358	2808	5166	0.00027
Bordetella trematum	123899	S	1844	711	2555	0.00013
Bordetella pseudohinzii	1331258	S	1564	691	2255	0.00012
Bordetella bronchiseptica	518	S	1556	9252	10808	0.00057
Pigmentiphaga sp. H8	2488560	S	8594	984	9578	0.00050
Pigmentiphaga aceris	1940612	S	1377	83	1460	0.00008
Orrella dioscoreae	1851544	S	2537	812	3349	0.00018
Castellaniella defragrans	75697	S	2889	1709	4598	0.00024
Rhizobacter sp. AJA081-3	2753607	S	8336	1944	10280	0.00054
Rhizobacter gummiphilus	946333	S	7860	1418	9278	0.00049
Sphaerotilus sp. FB-5	2914710	S	5045	2829	7874	0.00041
Sphaerotilus natans	34103	S	4850	1732	6582	0.00034
Methylibium petroleiphilum	105560	S	3280	2873	6153	0.00032
Methylibium sp. Pch-M	2082386	S	3129	2583	5712	0.00030
Rubrivivax gelatinosus	28068	S	8054	2295	10349	0.00054
Aquincola tertiaricarbonis	391953	S	6892	2154	9046	0.00047
Thiomonas sp. X19	1050370	S	2240	1510	3750	0.00020
Thiomonas intermedia	926	S	1568	483	2051	0.00011
Mitsuaria sp. 7	1658665	S	5695	1031	6726	0.00035
Leptothrix cholodnii	34029	S	5653	1642	7295	0.00038
Xylophilus rhododendri	2697032	S	4503	1182	5685	0.00030
Ideonella dechloratans	36863	S	3312	1792	5104	0.00027
Roseateles depolymerans	76731	S	2647	461	3108	0.00016
Aquabacterium olei	1296669	S	2620	628	3248	0.00017
Tepidimonas taiwanensis	307486	S	2608	844	3452	0.00018
Inhella inkyongensis	392593	S	1728	250	1978	0.00010
Paucibacter sp. KCTC 42545	1768242	S	1710	265	1975	0.00010
Thauera sp. MZ1T	85643	S	4187	3660	7847	0.00041
Thauera sp. K11	2005884	S	4083	2162	6245	0.00033
Thauera humireducens	1134435	S	2524	1295	3819	0.00020
Thauera chlorobenzoica	96773	S	1939	1520	3459	0.00018
Thauera aromatica	59405	S	1823	2172	3995	0.00021
Thauera hydrothermalis	2184083	S	1208	303	1511	0.00008
Azoarcus sp. KH32C	748247	S	4304	698	5002	0.00026
Azoarcus sp. DD4	2027405	S	3233	1823	5056	0.00026
Azoarcus olearius	418699	S	3864	1277	5141	0.00027
Azoarcus communis	41977	S	2789	921	3710	0.00019
Nitrogeniibacter mangrovi	2016596	S	3151	597	3748	0.00020
Nitrogeniibacter aestuarii	2815343	S	1515	151	1666	0.00009
Aromatoleum petrolei	76116	S	3913	864	4777	0.00025
Aromatoleum aromaticum	551760	S	2998	1937	4935	0.00026
Aromatoleum pumilum	2067960	S	2616	852	3468	0.00018
Aromatoleum bremense	76115	S	2542	1316	3858	0.00020
Azospira restricta	404405	S	6280	4225	10505	0.00055
Niveibacterium microcysteis	2811415	S	2519	320	2839	0.00015
Oryzomicrobium terrae	1735038	S	1821	415	2236	0.00012
Dechloromonas denitrificans	281362	S	2820	795	3615	0.00019
Ferribacterium limneticum	76259	S	3627	581	4208	0.00022
Quatrionicoccus australiensis	138118	S	1625	451	2076	0.00011
Usitatibacter rugosus	2732067	S	14284	1597	15881	0.00083
Usitatibacter palustris	2732487	S	10488	1251	11739	0.00061
Nitrosospira lacus	1288494	S	4158	155	4313	0.00023
Nitrosospira multiformis	1231	S	3564	123	3687	0.00019
Nitrosospira briensis	35799	S	1828	1271	3099	0.00016
Nitrosospira sp. NRS527	155925	S	1823	1182	3005	0.00016
Denitratisoma sp. DHT3	1981880	S	2438	1590	4028	0.00021
Denitratisoma oestradiolicum	311182	S	1231	184	1415	0.00007
Sulfuritalea hydrogenivorans	748811	S	2909	402	3311	0.00017
Methyloversatilis sp. RAC08	1842540	S	2554	310	2864	0.00015
Sterolibacterium denitrificans	157592	S	1807	446	2253	0.00012
Thiobacillus denitrificans	36861	S	3558	633	4191	0.00022
Sulfuritortus calidifontis	1914471	S	2356	905	3261	0.00017
Sideroxydans sp. MIZ01	2764705	S	1338	305	1643	0.00009
Ferrigenium kumadai	1682490	S	1579	342	1921	0.00010
Sulfuriferula plumbiphila	171865	S	1221	206	1427	0.00007
Sulfurimicrobium lacus	2715678	S	1930	250	2180	0.00011
Chromobacterium sp. ATCC 53434	2059672	S	2150	1159	3309	0.00017
Chromobacterium violaceum	536	S	2158	2457	4615	0.00024
Chromobacterium vaccinii	1108595	S	2081	1763	3844	0.00020
Chromobacterium phragmitis	2202141	S	1342	1215	2557	0.00013
Chromobacterium paludis	2605945	S	1158	796	1954	0.00010
Jeongeupia sp. USM3	1906741	S	2806	652	3458	0.00018
Jeongeupia sp. HS-3	1009682	S	1319	228	1547	0.00008
Paludibacterium paludis	1225769	S	1345	245	1590	0.00008
Paludibacterium yongneupense	400061	S	1297	171	1468	0.00008
Pseudogulbenkiania sp. NH8B	748280	S	3146	973	4119	0.00022
Vogesella sp. LIG4	1192162	S	1563	397	1960	0.00010
Microvirgula aerodenitrificans	57480	S	1854	318	2172	0.00011
Laribacter hongkongensis	168471	S	1194	960	2154	0.00011
Crenobacter cavernae	2290923	S	2862	1364	4226	0.00022
Chitinolyticbacter meiyuanensis	682798	S	1900	428	2328	0.00012
Casimicrobium huifangae	2591109	S	2054	824	2878	0.00015
Pseudomonas sp. S34	1573718	S	9845	3464	13309	0.00070
Pseudomonas sp. LAB-08	143813	S	7363	1803	9166	0.00048
Pseudomonas sp. UW4	1207075	S	2247	1890	4137	0.00022
Pseudomonas sp. SCB32	2653853	S	1861	548	2409	0.00013
Pseudomonas sp. ATCC 13867	1294143	S	1837	801	2638	0.00014
Pseudomonas sp. MM213	2866807	S	1812	573	2385	0.00012
Pseudomonas sp. PDNC002	2811422	S	1785	533	2318	0.00012
Pseudomonas sp. PP3	2815936	S	1784	809	2593	0.00014
Pseudomonas sp. URMO17WK12:I11	1283291	S	1697	1584	3281	0.00017
Pseudomonas sp. Ost2	2678260	S	1625	273	1898	0.00010
Pseudomonas sp. MPC6	2498848	S	1533	438	1971	0.00010
Pseudomonas sp. AN-B15	2697023	S	1476	11915	13391	0.00070
Pseudomonas sp. KNUC1026	2893890	S	1318	121	1439	0.00008
Pseudomonas sp. ACM7	2052956	S	1262	376	1638	0.00009
Pseudomonas sp. 31-12	2201356	S	1253	501	1754	0.00009
Pseudomonas sp. TCU-HL1	1856685	S	1188	195	1383	0.00007
Pseudomonas sp. Leaf58	1736226	S	1157	272	1429	0.00007
Pseudomonas sp. DY-1	1755504	S	1102	163	1265	0.00007
Pseudomonas sp. LPB0260	2614442	S	1102	223	1325	0.00007
Pseudomonas sp. CC6-YY-74	1930532	S	1001	117	1118	0.00006
Pseudomonas putida	303	S	33151	36023	69174	0.00362
Pseudomonas oryzihabitans	47885	S	3030	579	3609	0.00019
Pseudomonas fulva	47880	S	1950	4617	6567	0.00034
Pseudomonas fluorescens	294	S	15196	11695	26891	0.00141
Pseudomonas protegens	380021	S	2498	16221	18719	0.00098
Pseudomonas orientalis	76758	S	1669	457	2126	0.00011
Pseudomonas azotoformans	47878	S	1350	531	1881	0.00010
Pseudomonas synxantha	47883	S	1320	982	2302	0.00012
Pseudomonas rhodesiae	76760	S	1005	354	1359	0.00007
Pseudomonas aeruginosa	287	S	8795	100764	109559	0.00574
Pseudomonas mendocina	300	S	3115	942	4057	0.00021
Pseudomonas alcaligenes	43263	S	2598	1417	4015	0.00021
Pseudomonas furukawaii	1149133	S	1660	407	2067	0.00011
Pseudomonas multiresinivorans	95301	S	1394	443	1837	0.00010
Pseudomonas resinovorans	53412	S	1845	340	2185	0.00011
Pseudomonas citronellolis	53408	S	1042	1383	2425	0.00013
Pseudomonas stutzeri	316	S	10845	6073	16918	0.00089
Pseudomonas balearica	74829	S	1847	1923	3770	0.00020
Pseudomonas syringae	317	S	2864	8126	10990	0.00058
Pseudomonas amygdali	47877	S	2164	4342	6506	0.00034
Pseudomonas viridiflava	33069	S	1770	191	1961	0.00010
Pseudomonas cichorii	36746	S	1043	83	1126	0.00006
Pseudomonas umsongensis	198618	S	7955	1137	9092	0.00048
Pseudomonas chlororaphis	587753	S	6400	6017	12417	0.00065
Pseudomonas otitidis	319939	S	2920	563	3483	0.00018
Pseudomonas psychrotolerans	237610	S	2905	571	3476	0.00018
Pseudomonas knackmussii	65741	S	2770	2077	4847	0.00025
Pseudomonas oryzae	1392877	S	2436	666	3102	0.00016
Pseudomonas vancouverensis	95300	S	2434	344	2778	0.00015
Pseudomonas entomophila	312306	S	2317	913	3230	0.00017
Pseudomonas frederiksbergensis	104087	S	2142	582	2724	0.00014
Pseudomonas azerbaijanoriens	2842350	S	2044	1257	3301	0.00017
Pseudomonas guangdongensis	1245526	S	1789	498	2287	0.00012
Pseudomonas cavernae	2320867	S	1650	226	1876	0.00010
Pseudomonas koreensis	198620	S	1456	519	1975	0.00010
Pseudomonas lalkuanensis	2604832	S	1397	225	1622	0.00009
Pseudomonas arsenicoxydans	702115	S	1383	272	1655	0.00009
Pseudomonas reinekei	395598	S	1339	346	1685	0.00009
Pseudomonas vanderleydeniana	2745495	S	1319	162	1481	0.00008
Pseudomonas qingdaonensis	2056231	S	1292	228	1520	0.00008
Pseudomonas parafulva	157782	S	1267	327	1594	0.00008
Pseudomonas silesiensis	1853130	S	1251	239	1490	0.00008
Pseudomonas eucalypticola	2599595	S	1210	136	1346	0.00007
Pseudomonas brassicacearum	930166	S	1179	2119	3298	0.00017
Pseudomonas alkylphenolica	237609	S	1080	185	1265	0.00007
Pseudomonas prosekii	1148509	S	1042	154	1196	0.00006
Pseudomonas yamanorum	515393	S	1036	209	1245	0.00007
Azotobacter chroococcum	353	S	2504	951	3455	0.00018
Azotobacter vinelandii	354	S	1671	3992	5663	0.00030
Azotobacter salinestris	69964	S	1420	412	1832	0.00010
Lysobacter sp. KIS68-7	2904252	S	6453	1157	7610	0.00040
Lysobacter sp. TY2-98	2290922	S	3844	557	4401	0.00023
Lysobacter sp. 5GHs7-4	2904253	S	3180	917	4097	0.00021
Lysobacter sp. K5869	2820808	S	2713	1299	4012	0.00021
Lysobacter sp. CECT 30171	2822368	S	2444	547	2991	0.00016
Lysobacter sp. S4-A87	2925843	S	2358	754	3112	0.00016
Lysobacter sp. CW239	2762611	S	1861	911	2772	0.00015
Lysobacter capsici	435897	S	12639	13662	26301	0.00138
Lysobacter enzymogenes	69	S	10958	3826	14784	0.00077
Lysobacter soli	453783	S	4444	833	5277	0.00028
Lysobacter antibioticus	84531	S	3802	748	4550	0.00024
Lysobacter lycopersici	1324796	S	3723	707	4430	0.00023
Lysobacter solisilvae (ex Woo and Kim 2022)	2865112	S	3453	923	4376	0.00023
Lysobacter solisilvae (ex Kim et al. 2021)	2763317	S	3407	617	4024	0.00021
Lysobacter maris	1605891	S	3195	696	3891	0.00020
Lysobacter arenosi	2795387	S	2345	721	3066	0.00016
Lysobacter alkalisoli	2591633	S	2309	373	2682	0.00014
Lysobacter oculi	2698682	S	2066	496	2562	0.00013
Xanthomonas translucens	343	S	6491	8250	14741	0.00077
Xanthomonas sp. GW	2724121	S	1219	1595	2814	0.00015
Xanthomonas sp. SS	2724122	S	1144	1733	2877	0.00015
Xanthomonas sp. SI	2724123	S	1097	1677	2774	0.00015
Xanthomonas campestris	339	S	3587	3546	7133	0.00037
Xanthomonas sacchari	56458	S	2610	814	3424	0.00018
Xanthomonas arboricola	56448	S	2234	2589	4823	0.00025
Xanthomonas theicola	56464	S	1931	589	2520	0.00013
Xanthomonas hyacinthi	56455	S	1775	1015	2790	0.00015
Xanthomonas oryzae	347	S	1759	781	2540	0.00013
Xanthomonas citri	346	S	1529	11747	13276	0.00070
Xanthomonas vesicatoria	56460	S	1078	571	1649	0.00009
Xanthomonas albilineans	29447	S	1046	132	1178	0.00006
Xanthomonas hortorum	56454	S	1010	884	1894	0.00010
Stenotrophomonas maltophilia	40324	S	11903	21250	33153	0.00174
Stenotrophomonas rhizophila	216778	S	9126	2645	11771	0.00062
Stenotrophomonas sp. LM091	1904944	S	1476	771	2247	0.00012
Stenotrophomonas sp. 169	2770322	S	1206	218	1424	0.00007
Stenotrophomonas sp. 364	2691571	S	1019	603	1622	0.00009
Stenotrophomonas acidaminiphila	128780	S	2757	6696	9453	0.00050
Luteimonas sp. S4-F44	2925842	S	2774	471	3245	0.00017
Luteimonas sp. MC1750	2799326	S	2751	885	3636	0.00019
Luteimonas sp. D4P002	2901869	S	2489	562	3051	0.00016
Luteimonas sp. MC1572	2799325	S	2149	909	3058	0.00016
Luteimonas sp. YGD11-2	2508168	S	2135	796	2931	0.00015
Luteimonas sp. JM171	1896164	S	2037	358	2395	0.00013
Luteimonas sp. MC1825	2761107	S	2005	871	2876	0.00015
Luteimonas granuli	1176533	S	2495	752	3247	0.00017
Luteimonas chenhongjianii	2006110	S	2152	405	2557	0.00013
Luteimonas yindakuii	2565782	S	2038	686	2724	0.00014
Pseudoxanthomonas suwonensis	314722	S	5386	2423	7809	0.00041
Pseudoxanthomonas sp. X-1	2571115	S	3448	2606	6054	0.00032
Pseudoxanthomonas mexicana	128785	S	3065	4539	7604	0.00040
Pseudoxanthomonas spadix	415229	S	2207	716	2923	0.00015
Pseudoxanthomonas daejeonensis	266062	S	2199	504	2703	0.00014
Thermomonas sp. XSG	2771436	S	1940	730	2670	0.00014
Thermomonas sp. HDW16	2714945	S	1444	336	1780	0.00009
Thermomonas brevis	215691	S	2907	1027	3934	0.00021
Thermomonas aquatica	2202149	S	2647	1212	3859	0.00020
Thermomonas carbonis	1463158	S	2132	393	2525	0.00013
Arenimonas daejeonensis	370777	S	2911	520	3431	0.00018
Pseudolysobacter antarcticus	2511995	S	2405	58	2463	0.00013
Luteibacter sp. 321	2911537	S	2811	695	3506	0.00018
Luteibacter sp. EIF3	2780091	S	2180	292	2472	0.00013
Luteibacter sp. 335	2911538	S	2064	395	2459	0.00013
Luteibacter sp. 353	2911539	S	1734	447	2181	0.00011
Luteibacter pinisoli	2589080	S	2226	485	2711	0.00014
Luteibacter rhizovicinus	242606	S	2219	262	2481	0.00013
Luteibacter anthropi	564369	S	1689	258	1947	0.00010
Dyella thiooxydans	445710	S	6520	1742	8262	0.00043
Dyella japonica	231455	S	2452	689	3141	0.00016
Dyella telluris	2763498	S	2273	565	2838	0.00015
Dyella terrae	522259	S	1738	227	1965	0.00010
Dyella caseinilytica	1849581	S	1250	86	1336	0.00007
Rhodanobacter denitrificans	666685	S	4707	1708	6415	0.00034
Rhodanobacter sp. FDAARGOS 1247	2778082	S	3043	921	3964	0.00021
Rhodanobacter thiooxydans	416169	S	2803	1255	4058	0.00021
Rhodanobacter glycinis	582702	S	2306	366	2672	0.00014
Frateuria sp. 5GH9-34	2898793	S	7247	1990	9237	0.00048
Frateuria sp. 5GH9-11	1542730	S	3786	1320	5106	0.00027
Frateuria aurantia	81475	S	1049	118	1167	0.00006
Dokdonella koreensis	323415	S	7253	1111	8364	0.00044
Aerosticca soli	2010829	S	3077	3352	6429	0.00034
Ahniella affigens	2021234	S	1374	31	1405	0.00007
Klebsiella pneumoniae	573	S	1246	43514	44760	0.00234
Enterobacter cloacae	550	S	1238	6396	7634	0.00040
Salmonella enterica	28901	S	1472	53055	54527	0.00286
Pluralibacter gergoviae	61647	S	1082	273	1355	0.00007
Escherichia coli	562	S	1016	23965	24981	0.00131
Serratia marcescens	615	S	2404	9307	11711	0.00061
Pantoea agglomerans	549	S	1651	1529	3180	0.00017
Pantoea dispersa	59814	S	1390	654	2044	0.00011
Thioalkalivibrio paradoxus	108010	S	1771	464	2235	0.00012
Thioalkalivibrio nitratireducens	186931	S	1707	406	2113	0.00011
Thioalkalivibrio sulfidiphilus	1033854	S	1686	865	2551	0.00013
Thioalkalivibrio sp. K90mix	396595	S	1411	156	1567	0.00008
Thioalkalivibrio versutus	106634	S	1362	156	1518	0.00008
Spiribacter sp. E85	2182432	S	3620	350	3970	0.00021
Acidihalobacter aeolianus	2792603	S	1558	197	1755	0.00009
Acidihalobacter ferrooxydans	1765967	S	1274	117	1391	0.00007
Halorhodospira halophila	1053	S	1661	172	1833	0.00010
Alkalilimnicola ehrlichii	351052	S	1624	184	1808	0.00009
Aquisalimonas sp. 2447	2740807	S	1600	98	1698	0.00009
Candidatus Thiodictyon syntrophicum	1166950	S	3304	151	3455	0.00018
Allochromatium vinosum	1049	S	1432	475	1907	0.00010
Allochromatium tepidum	553982	S	1336	546	1882	0.00010
Marichromatium purpuratum	37487	S	2948	487	3435	0.00018
Thioflavicoccus mobilis	80679	S	2854	224	3078	0.00016
Thiocapsa bogorovii	521689	S	2320	106	2426	0.00013
Thiocystis violascens	73141	S	1695	123	1818	0.00010
Thermochromatium tepidum	1050	S	1068	207	1275	0.00007
Wenzhouxiangella marina	1579979	S	1895	105	2000	0.00010
Wenzhouxiangella sp. AB-CW3	2771012	S	1154	44	1198	0.00006
Guyparkeria halophila	47960	S	1768	375	2143	0.00011
Sulfurivermis fontis	1972068	S	1574	519	2093	0.00011
Halomonas sp. THAF5a	2587844	S	1864	1493	3357	0.00018
Halomonas sp. THAF12	2587849	S	1505	1631	3136	0.00016
Halomonas sp. 1513	1883416	S	1498	995	2493	0.00013
Halomonas sp. HG01	1609967	S	1372	1133	2505	0.00013
Halomonas sp. YLGW01	2773308	S	1191	345	1536	0.00008
Halomonas sp. JS92-SW72	2306583	S	1171	2321	3492	0.00018
Halomonas sp. MCCC 1A13316	2733487	S	1094	353	1447	0.00008
Halomonas beimenensis	475662	S	1964	906	2870	0.00015
Halomonas aestuarii	1897729	S	1508	838	2346	0.00012
Halomonas socia	1081866	S	1384	849	2233	0.00012
Halomonas sulfidivorans	2733488	S	1130	714	1844	0.00010
Halomonas tianxiuensis	2497861	S	1111	889	2000	0.00010
Halomonas elongata	2746	S	1101	228	1329	0.00007
Halotalea alkalilenta	376489	S	1968	445	2413	0.00013
Salinicola tamaricis	1771309	S	1865	410	2275	0.00012
Chromohalobacter salexigens	158080	S	1259	281	1540	0.00008
Alcanivorax sp. N3-2A	2014542	S	1468	1921	3389	0.00018
Alcanivorax pacificus	1306787	S	1048	366	1414	0.00007
Aeromonas hydrophila	644	S	1932	11854	13786	0.00072
Aeromonas veronii	654	S	1308	3024	4332	0.00023
Zobellella denitrificans	347534	S	1293	291	1584	0.00008
Methylococcus sp. EFPC2	2812648	S	1567	140	1707	0.00009
Methylococcus sp. Mc7	2860258	S	1426	449	1875	0.00010
Methylococcus capsulatus	414	S	1392	350	1742	0.00009
Methylococcus geothermalis	2681310	S	1085	307	1392	0.00007
Methylomagnum ishizawai	1760988	S	1911	112	2023	0.00011
Methylomicrobium album	39775	S	1386	90	1476	0.00008
Methylogaea oryzae	1295382	S	1607	170	1777	0.00009
Methylocaldum marinum	1432792	S	1442	104	1546	0.00008
Kineobactrum salinum	2708301	S	1050	188	1238	0.00006
Solimonas sp. K1W22B-7	2303331	S	5867	517	6384	0.00033
Flagellatimonas centrodinii	2806210	S	1736	101	1837	0.00010
Steroidobacter denitrificans	465721	S	2668	646	3314	0.00017
Sulfurifustis variabilis	1675686	S	5480	312	5792	0.00030
Sulfuricaulis limicola	1620215	S	2231	154	2385	0.00012
Immundisolibacter cernigliae	1810504	S	2794	435	3229	0.00017
Salinisphaera sp. LB1	2183911	S	1915	69	1984	0.00010
endosymbiont of unidentified scaly snail isolate Monju	1248727	S	1395	103	1498	0.00008
Corallococcus coralloides	184914	S	38410	7212	45622	0.00239
Corallococcus sp. EGB	1521117	S	9143	1354	10497	0.00055
Corallococcus macrosporus	35	S	5705	602	6307	0.00033
Myxococcus xanthus	34	S	10324	49220	59544	0.00312
Myxococcus hansupus	1297742	S	4850	268	5118	0.00027
Myxococcus stipitatus	83455	S	4389	295	4684	0.00025
Myxococcus sp. SCHIC003	2813577	S	3828	261	4089	0.00021
Pyxidicoccus sp. SCPEA002	2813578	S	18295	596	18891	0.00099
Archangium violaceum	83451	S	21116	3483	24599	0.00129
Archangium gephyra	48	S	14327	2727	17054	0.00089
Cystobacter fuscus	43	S	8206	1905	10111	0.00053
Stigmatella aurantiaca	41	S	7352	438	7790	0.00041
Melittangium boletus	83453	S	6213	1304	7517	0.00039
Anaeromyxobacter sp. Red232	2918170	S	15126	1435	16561	0.00087
Anaeromyxobacter sp. Red630	2918171	S	11655	1332	12987	0.00068
Anaeromyxobacter sp. Fw109-5	404589	S	11421	1316	12737	0.00067
Anaeromyxobacter sp. K	447217	S	2984	5753	8737	0.00046
Anaeromyxobacter dehalogenans	161493	S	9369	6564	15933	0.00083
Vulgatibacter incomptus	1391653	S	7135	454	7589	0.00040
Sorangium cellulosum	56	S	93976	9678	103654	0.00543
Polyangium aurulentum	2567896	S	23533	1945	25478	0.00133
Chondromyces crocatus	52	S	11165	454	11619	0.00061
Sandaracinus amylolyticus	927083	S	34197	1698	35895	0.00188
Labilithrix luteola	1391654	S	22344	849	23193	0.00121
Haliangium ochraceum	80816	S	16586	712	17298	0.00091
Geomonas sp. RF6	2897342	S	2215	236	2451	0.00013
Geomonas paludis	2740185	S	1832	760	2592	0.00014
Geomonas nitrogeniifigens	2847991	S	1762	748	2510	0.00013
Geomonas subterranea	2847989	S	1562	599	2161	0.00011
Geomonas oryzisoli	2847992	S	1488	672	2160	0.00011
Geobacter sp. FeAm09	2597769	S	1572	171	1743	0.00009
Geobacter sp. SVR	2495594	S	1194	148	1342	0.00007
Geobacter sulfurreducens	35554	S	1773	321	2094	0.00011
Geobacter pickeringii	345632	S	1577	348	1925	0.00010
Geobacter metallireducens	28232	S	1067	217	1284	0.00007
Citrifermentans bemidjiense	225194	S	1442	451	1893	0.00010
Citrifermentans bremense	60035	S	1415	483	1898	0.00010
Desulfuromonas versatilis	2802975	S	2709	410	3119	0.00016
Desulfuromonas sp. DDH964	1823759	S	1904	301	2205	0.00012
Desulfuromonas soudanensis	1603606	S	1759	171	1930	0.00010
Pelobacter propionicus	29543	S	1132	341	1473	0.00008
Desulfovibrio vulgaris	881	S	1164	103	1267	0.00007
Desulfovibrio sulfodismutans	63561	S	1076	440	1516	0.00008
Pseudodesulfovibrio mercurii	641491	S	1526	359	1885	0.00010
Pseudodesulfovibrio indicus	1716143	S	1447	299	1746	0.00009
Pseudodesulfovibrio aespoeensis	182210	S	1069	673	1742	0.00009
Solidesulfovibrio carbinoliphilus	345370	S	1949	272	2221	0.00012
Solidesulfovibrio magneticus	184917	S	1042	925	1967	0.00010
Oceanidesulfovibrio marinus	370038	S	1863	123	1986	0.00010
Desulfocurvibacter africanus	873	S	1295	101	1396	0.00007
Desulfolutivibrio sulfoxidireducens	2773299	S	1281	376	1657	0.00009
Megalodesulfovibrio gigas	879	S	1102	57	1159	0.00006
Desulfosarcina ovata	83564	S	1204	264	1468	0.00008
Persicimonas caeni	2292766	S	5518	147	5665	0.00030
Bradymonas sediminis	1548548	S	1980	122	2102	0.00011
Syntrophobacter fumaroxidans	119484	S	1205	402	1607	0.00008
Desulfarculus baarsii	453230	S	2051	955	3006	0.00016
Bdellovibrio sp. NC01	2220073	S	2111	230	2341	0.00012
Gemmata obscuriglobus	114	S	15132	1902	17034	0.00089
Gemmata massiliana	1210884	S	7354	2923	10277	0.00054
Gemmata sp. SH-PL17	1630693	S	6678	2990	9668	0.00051
Urbifossiella limnaea	2528023	S	27242	2153	29395	0.00154
Frigoriglobus tundricola	2774151	S	18968	2900	21868	0.00115
Limnoglobus roseus	2598579	S	14100	603	14703	0.00077
Tuwongella immobilis	692036	S	1754	63	1817	0.00010
Telmatocola sphagniphila	1123043	S	1364	11	1375	0.00007
Aquisphaera giovannonii	406548	S	23638	3196	26834	0.00141
Tautonia plasticadhaerens	2527974	S	21072	1488	22560	0.00118
Paludisphaera borealis	1387353	S	17408	2997	20405	0.00107
Singulisphaera acidiphila	466153	S	14375	1656	16031	0.00084
Isosphaera pallida	128	S	2103	120	2223	0.00012
Stieleria neptunia	2527979	S	2024	183	2207	0.00012
Stieleria maiorica	2795974	S	1949	310	2259	0.00012
Lignipirellula cremea	2528010	S	3740	354	4094	0.00021
Rosistilla oblonga	2527990	S	1163	1061	2224	0.00012
Anatilimnocola aggregata	2528021	S	3304	291	3595	0.00019
Pirellula staleyi	125	S	1779	58	1837	0.00010
Bremerella volcania	2527984	S	2255	135	2390	0.00013
Roseimaritima ulvae	980254	S	1637	87	1724	0.00009
Rubripirellula lacrimiformis	1930273	S	1010	155	1165	0.00006
Lacipirellula parvula	2650471	S	4361	463	4824	0.00025
Lacipirellula limnantheis	2528024	S	3916	482	4398	0.00023
Pirellulimonas nuda	2528009	S	5108	495	5603	0.00029
Botrimarina mediterranea	2528022	S	4343	361	4704	0.00025
Aeoliella mucimassa	2527972	S	1659	123	1782	0.00009
Planctomyces sp. SH-PL62	1636152	S	13958	3823	17781	0.00093
Planctomyces sp. SH-PL14	1632864	S	6189	331	6520	0.00034
Gimesia panareensis	2527978	S	1423	1152	2575	0.00013
Alienimonas californiensis	2527989	S	4315	274	4589	0.00024
Caulifigura coniformis	2527983	S	4209	239	4448	0.00023
Maioricimonas rarisocia	2528026	S	3855	429	4284	0.00022
Symmachiella dynata	2527995	S	1766	92	1858	0.00010
Fuerstiella marisgermanici	1891926	S	1018	15	1033	0.00005
Rubinisphaera brasiliensis	119	S	1003	87	1090	0.00006
Humisphaera borealis	2807512	S	8336	177	8513	0.00045
Phycisphaera mikurensis	547188	S	4316	287	4603	0.00024
Mucisphaera calidilacus	2527982	S	1788	77	1865	0.00010
Opitutus sp. GAS368	1882749	S	6476	844	7320	0.00038
Opitutus terrae	107709	S	6039	245	6284	0.00033
Lacunisphaera limnophila	1838286	S	4432	556	4988	0.00026
Oleiharenicola sp. KSB-15	2862869	S	3024	141	3165	0.00017
Nibricoccus aquaticus	2576891	S	2945	119	3064	0.00016
Ereboglobus luteus	1796921	S	2030	89	2119	0.00011
Verrucomicrobium spinosum	2736	S	3366	178	3544	0.00019
Verrucomicrobium sp. GAS474	1882831	S	3102	297	3399	0.00018
Luteolibacter ambystomatis	2824561	S	2069	121	2190	0.00011
Luteolibacter luteus	2728835	S	1908	75	1983	0.00010
Roseimicrobium sp. ORNL1	2711231	S	2498	79	2577	0.00014
Akkermansia muciniphila	239935	S	1258	125	1383	0.00007
Kiritimatiella glycovorans	1307763	S	1123	1039	2162	0.00011
Hymenobacter sp. 5317J-9	2932250	S	1253	1061	2314	0.00012
Hymenobacter sp. PAMC 26628	1484118	S	1239	1056	2295	0.00012
Hymenobacter sp. PAMC 26554	1484116	S	1139	365	1504	0.00008
Hymenobacter sp. APR13	1356852	S	1026	1710	2736	0.00014
Hymenobacter sp. BRD128	2675878	S	1015	462	1477	0.00008
Hymenobacter monticola	1705399	S	1224	753	1977	0.00010
Hymenobacter busanensis	2607656	S	1066	366	1432	0.00008
Dyadobacter fermentans	94254	S	1314	231	1545	0.00008
Chryseolinea soli	2321403	S	1740	105	1845	0.00010
Niastella koreensis	354356	S	15415	895	16310	0.00085
Panacibacter ginsenosidivorans	1813871	S	3239	95	3334	0.00017
Mucilaginibacter gossypii	551996	S	4345	2610	6955	0.00036
Mucilaginibacter sp. SMC90	2929803	S	2791	184	2975	0.00016
Mucilaginibacter rubeus	2027860	S	2417	4857	7274	0.00038
Pedobacter ginsengisoli	363852	S	1024	292	1316	0.00007
Rhodothermus marinus	29549	S	4232	222	4454	0.00023
Rhodocaloribacter litoris	2558931	S	4037	428	4465	0.00023
Salinibacter ruber	146919	S	2890	55	2945	0.00015
Gemmatirosa kalamazoonesis	861299	S	71498	5593	77091	0.00404
Gemmatimonas groenlandica	2732249	S	8320	835	9155	0.00048
Gemmatimonas aurantiaca	173480	S	5794	521	6315	0.00033
Gemmatimonas phototrophica	1379270	S	4881	596	5477	0.00029
Granulicella sp. WH15	2602070	S	3715	594	4309	0.00023
Granulicella sp. 5B5	1617967	S	3012	435	3447	0.00018
Granulicella mallensis	940614	S	2972	318	3290	0.00017
Granulicella tundricola	940615	S	2298	270	2568	0.00013
Terriglobus roseus	392734	S	3935	729	4664	0.00024
Terriglobus albidus	1592106	S	2975	254	3229	0.00017
Terriglobus saanensis	870903	S	1896	222	2118	0.00011
Candidatus Koribacter versatilis	658062	S	7531	233	7764	0.00041
Acidobacterium capsulatum	33075	S	3687	422	4109	0.00022
Acidobacterium sp. 4Y35	2763107	S	3648	239	3887	0.00020
Edaphobacter sp. 12200R-103	2703788	S	4267	647	4914	0.00026
Edaphobacter sp. 4G125	2763071	S	1657	214	1871	0.00010
Acidisarcina polymorpha	2211140	S	2685	178	2863	0.00015
Paludibaculum fermentans	1473598	S	9016	215	9231	0.00048
Luteitalea sp. TBR-22	2802971	S	19818	3231	23049	0.00121
Luteitalea pratensis	1855912	S	16435	1702	18137	0.00095
Chloracidobacterium aggregatum	2851959	S	1266	1519	2785	0.00015
Sulfidibacter corallicola	2818388	S	2457	45	2502	0.00013
Nitrospira moscoviensis	42253	S	4726	295	5021	0.00026
Nitrospira japonica	1325564	S	2647	219	2866	0.00015
Candidatus Nitrospira inopinata	1715989	S	1926	118	2044	0.00011
Nitrospira sp. KM1	1936990	S	1710	109	1819	0.00010
Fusarium acuminatum	5515	S	8024	737	8761	0.00046
Fusarium oxysporum	5507	S	4743	2232	6975	0.00037
Metarhizium album	92629	S	1012	1215	2227	0.00012
Ustilaginoidea virens	1159556	S	1405	91	1496	0.00008
Pochonia chlamydosporia	280754	S	1153	106	1259	0.00007
Beauveria felina	37994	S	1464	1413	2877	0.00015
Cordyceps fumosorosea	114497	S	2166	223	2389	0.00013
Purpureocillium lilacinum	33203	S	4232	387	4619	0.00024
Drechmeria coniospora	98403	S	1889	106	1995	0.00010
Clonostachys rosea	29856	S	1161	114	1275	0.00007
Colletotrichum higginsianum	80884	S	2788	664	3452	0.00018
Thermothielavioides terrestris	2587410	S	3434	242	3676	0.00019
Thermothelomyces thermophilus	78579	S	2892	150	3042	0.00016
Pyricularia oryzae	318829	S	1060	274	1334	0.00007
Pyricularia pennisetigena	1578925	S	1023	155	1178	0.00006
Aspergillus fumigatus	746128	S	4310	186	4496	0.00024
Aspergillus chevalieri	182096	S	3918	391	4309	0.00023
Aspergillus puulaauensis	1220207	S	2925	115	3040	0.00016
Talaromyces rugulosus	121627	S	2126	135	2261	0.00012
Paraphaeosphaeria minitans	565426	S	1096	443	1539	0.00008
Pseudozyma flocculosa	84751	S	3840	120	3960	0.00021
Phlebiopsis gigantea	82310	S	1272	17	1289	0.00007
Phytophthora cinnamomi	4785	S	2596	424	3020	0.00016
Phytophthora fragariae	53985	S	1949	267	2216	0.00012
Phytophthora infestans	4787	S	1158	1562	2720	0.00014
Phytophthora cryptogea	4786	S	1142	92	1234	0.00006
