name	taxonomy_id	taxonomy_lvl	kraken_assigned_reads	added_reads	new_est_reads	fraction_total_reads
Streptomyces	1883	G	1634420	412768	2047188	0.09940
Kitasatospora	2063	G	32630	12342	44972	0.00218
Streptacidiphilus	228398	G	21382	6576	27958	0.00136
Yinghuangia	2805681	G	13017	2221	15238	0.00074
Microbacterium	33882	G	232866	40990	273856	0.01330
Agromyces	33877	G	71426	16938	88364	0.00429
Agrococcus	46352	G	42680	12391	55071	0.00267
Curtobacterium	2034	G	41527	8777	50304	0.00244
Rathayibacter	33886	G	37509	8615	46124	0.00224
Clavibacter	1573	G	28087	18864	46951	0.00228
Leifsonia	110932	G	26355	6618	32973	0.00160
Leucobacter	55968	G	25904	5032	30936	0.00150
Protaetiibacter	2680004	G	12380	3584	15964	0.00078
Salinibacterium	235888	G	11154	1804	12958	0.00063
Cryobacterium	69578	G	10021	1448	11469	0.00056
Frondihabitans	447237	G	7879	1238	9117	0.00044
Microterricola	518733	G	7336	1795	9131	0.00044
Plantibacter	190323	G	7140	930	8070	0.00039
Microcella	337004	G	6334	2217	8551	0.00042
Cnuibacter	1759331	G	5205	1108	6313	0.00031
Herbiconiux	881616	G	4964	983	5947	0.00029
Frigoribacterium	96492	G	4911	1425	6336	0.00031
Diaminobutyricimonas	1433997	G	4705	877	5582	0.00027
Mycetocola	76634	G	4436	575	5011	0.00024
Gryllotalpicola	1195526	G	4176	808	4984	0.00024
Amnibacterium	1029631	G	4093	972	5065	0.00025
Subtercola	120212	G	3890	325	4215	0.00020
Humibacter	427753	G	3471	747	4218	0.00020
Chryseoglobus	1331730	G	3450	651	4101	0.00020
Marisediminicola	1230698	G	2920	360	3280	0.00016
Gulosibacter	256818	G	2727	785	3512	0.00017
Agreia	110934	G	2154	261	2415	0.00012
Glaciihabitans	1649454	G	2018	158	2176	0.00011
Rhodoluna	529883	G	310	16	326	0.00002
Aquiluna	529881	G	273	15	288	0.00001
Pseudoclavibacter	255204	G	420	79	499	0.00002
Aurantimicrobium	1705353	G	322	17	339	0.00002
Pontimonas	1434032	G	173	8	181	0.00001
Arthrobacter	1663	G	184903	44837	229740	0.01115
Pseudarthrobacter	1742993	G	58983	19267	78250	0.00380
Kocuria	57493	G	50340	14578	64918	0.00315
Citricoccus	169133	G	27822	7671	35493	0.00172
Micrococcus	1269	G	15788	10902	26690	0.00130
Sinomonas	596707	G	10629	2777	13406	0.00065
Glutamicibacter	1742989	G	8589	3207	11796	0.00057
Paenarthrobacter	1742992	G	8015	5026	13041	0.00063
Rothia	32207	G	5457	2433	7890	0.00038
Nesterenkonia	57494	G	1526	102	1628	0.00008
Paeniglutamicibacter	1742990	G	1050	178	1228	0.00006
Psychromicrobium	2078575	G	565	94	659	0.00003
Neomicrococcus	1868332	G	458	244	702	0.00003
Auritidibacter	1160973	G	400	42	442	0.00002
Renibacterium	1645	G	306	20	326	0.00002
Cellulomonas	1707	G	124393	44037	168430	0.00818
Actinotalea	458839	G	8341	3174	11515	0.00056
Oerskovia	162491	G	5790	1938	7728	0.00038
Pseudactinotalea	1926259	G	4447	678	5125	0.00025
Paraoerskovia	665568	G	3575	983	4558	0.00022
Cellulosimicrobium	157920	G	35758	15502	51260	0.00249
Xylanimonas	186188	G	19983	6760	26743	0.00130
Isoptericola	254250	G	16929	8087	25016	0.00121
Janibacter	53457	G	19364	6067	25431	0.00123
Phycicoccus	367298	G	16830	5073	21903	0.00106
Pedococcus	2805645	G	8779	2694	11473	0.00056
Intrasporangium	53357	G	7530	2123	9653	0.00047
Tetrasphaera	99479	G	6649	1805	8454	0.00041
Arsenicicoccus	267408	G	5709	2280	7989	0.00039
Ornithinimicrobium	125287	G	26851	5960	32811	0.00159
Serinicoccus	265976	G	19641	5592	25233	0.00123
Brachybacterium	43668	G	30796	5332	36128	0.00175
Dermabacter	36739	G	1795	1078	2873	0.00014
Devriesea	472568	G	381	22	403	0.00002
Georgenia	154116	G	30634	9294	39928	0.00194
Brevibacterium	1696	G	30501	6532	37033	0.00180
Ruania	626119	G	20844	2637	23481	0.00114
Dermacoccus	57495	G	6650	2396	9046	0.00044
Luteipulveratus	745364	G	5359	795	6154	0.00030
Allobranchiibius	2040262	G	4158	967	5125	0.00025
Yimella	908935	G	2560	550	3110	0.00015
Pengzhenrongella	2888818	G	9117	2645	11762	0.00057
Luteimicrobium	754249	G	6474	2051	8525	0.00041
Beutenbergia	84756	G	8316	1422	9738	0.00047
Miniimonas	947525	G	5599	2928	8527	0.00041
Sanguibacter	60919	G	10207	3190	13397	0.00065
Kytococcus	57499	G	3972	1491	5463	0.00027
Gephyromycinifex	2885697	G	1939	247	2186	0.00011
Austwickia	1184606	G	1478	125	1603	0.00008
Dermatophilus	1862	G	372	38	410	0.00002
Demequina	577469	G	1337	111	1448	0.00007
Jonesia	43673	G	253	48	301	0.00001
Mycolicibacterium	1866885	G	441558	75782	517340	0.02512
Mycobacterium	1763	G	251553	74225	325778	0.01582
Mycolicibacter	1073531	G	17000	5710	22710	0.00110
Mycobacteroides	670516	G	13464	3641	17105	0.00083
Mycolicibacillus	2126281	G	3392	877	4269	0.00021
Hoyosella	697025	G	1335	77	1412	0.00007
Rhodococcus	1827	G	179592	47373	226965	0.01102
Nocardia	1817	G	148831	27245	176076	0.00855
Gordonia	2053	G	79228	17628	96856	0.00470
Skermania	59613	G	3467	393	3860	0.00019
Corynebacterium	1716	G	79446	22828	102274	0.00497
Tsukamurella	2060	G	22214	5558	27772	0.00135
Dietzia	37914	G	13646	3101	16747	0.00081
Tomitella	741759	G	7504	1591	9095	0.00044
Segniliparus	286801	G	1697	97	1794	0.00009
Lawsonella	1847725	G	286	33	319	0.00002
Nocardioides	1839	G	717635	173255	890890	0.04326
Aeromicrobium	2040	G	50310	10936	61246	0.00297
Friedmanniella	53387	G	30770	6808	37578	0.00182
Mumia	1546255	G	13728	2653	16381	0.00080
Marmoricola	86795	G	12808	5246	18054	0.00088
Pimelobacter	2044	G	11496	4571	16067	0.00078
Micropruina	116071	G	4656	753	5409	0.00026
Microlunatus	29404	G	58252	7978	66230	0.00322
Tessaracoccus	72763	G	25453	5923	31376	0.00152
Brevilactibacter	2717325	G	11291	5080	16371	0.00079
Auraticoccus	1278221	G	10742	2178	12920	0.00063
Acidipropionibacterium	1912215	G	9279	4129	13408	0.00065
Propionibacterium	1743	G	8567	3153	11720	0.00057
Raineyella	1911549	G	4396	666	5062	0.00025
Arachnia	2801844	G	3937	329	4266	0.00021
Cutibacterium	1912216	G	3826	1028	4854	0.00024
Vaginimicrobium	2919589	G	105	41	146	0.00001
Kribbella	182639	G	34559	5875	40434	0.00196
Actinopolymorpha	117156	G	9866	1215	11081	0.00054
Micromonospora	1873	G	351198	95729	446927	0.02170
Actinoplanes	1865	G	239147	42888	282035	0.01369
Phytohabitans	907364	G	51000	7086	58086	0.00282
Plantactinospora	673534	G	33200	6095	39295	0.00191
Couchioplanes	56433	G	30318	7939	38257	0.00186
Dactylosporangium	35753	G	27853	3325	31178	0.00151
Catellatospora	53365	G	22864	5372	28236	0.00137
Actinocatenispora	390988	G	22748	3047	25795	0.00125
Polymorphospora	338583	G	16121	3685	19806	0.00096
Natronosporangium	2920401	G	7788	575	8363	0.00041
Verrucosispora	84593	G	6329	4687	11016	0.00053
Salinispora	168694	G	4507	775	5282	0.00026
Pseudonocardia	1847	G	300528	59054	359582	0.01746
Amycolatopsis	1813	G	235316	47475	282791	0.01373
Saccharothrix	2071	G	51229	16037	67266	0.00327
Saccharopolyspora	1835	G	45004	11039	56043	0.00272
Saccharomonospora	1851	G	28520	5725	34245	0.00166
Kutzneria	43356	G	27319	6305	33624	0.00163
Lentzea	165301	G	23807	5593	29400	0.00143
Actinoalloteichus	65496	G	16947	1696	18643	0.00091
Actinosynnema	40566	G	16882	5368	22250	0.00108
Kibdelosporangium	2029	G	14348	1921	16269	0.00079
Allokutzneria	1137960	G	11387	3026	14413	0.00070
Alloactinosynnema	674734	G	11134	2745	13879	0.00067
Prauserella	142577	G	5577	569	6146	0.00030
Allosaccharopolyspora	2893576	G	4829	1168	5997	0.00029
Blastococcus	38501	G	206069	65207	271276	0.01317
Geodermatophilus	1860	G	130867	46018	176885	0.00859
Modestobacter	88138	G	109322	36115	145437	0.00706
Actinomadura	1988	G	106821	22163	128984	0.00626
Thermomonospora	2019	G	20076	6566	26642	0.00129
Nonomuraea	83681	G	74984	14009	88993	0.00432
Streptosporangium	2000	G	26848	5640	32488	0.00158
Thermobispora	147067	G	7956	2085	10041	0.00049
Nocardiopsis	2013	G	29110	6001	35111	0.00170
Thermobifida	83677	G	12616	2780	15396	0.00075
Streptomonospora	104204	G	6460	1376	7836	0.00038
Spiractinospora	2913367	G	4369	314	4683	0.00023
Actinomyces	1654	G	38798	5714	44512	0.00216
Schaalia	2529408	G	4484	828	5312	0.00026
Flaviflexus	1522056	G	2697	701	3398	0.00016
Trueperella	1069494	G	2203	749	2952	0.00014
Pauljensenia	2740557	G	1297	448	1745	0.00008
Nanchangia	2888879	G	1094	128	1222	0.00006
Actinobaculum	76833	G	436	24	460	0.00002
Actinotignum	1653174	G	430	32	462	0.00002
Arcanobacterium	28263	G	316	88	404	0.00002
Changpingibacter	2912996	G	251	76	327	0.00002
Mobiluncus	2050	G	156	50	206	0.00001
Varibaculum	184869	G	103	33	136	0.00001
Frankia	1854	G	50695	5483	56178	0.00273
Jiangella	281472	G	37804	7148	44952	0.00218
Nakamurella	53460	G	21001	3110	24111	0.00117
Bifidobacterium	1678	G	17206	5843	23049	0.00112
Parascardovia	196082	G	283	43	326	0.00002
Catenulispora	414878	G	10544	1664	12208	0.00059
Kineococcus	33981	G	8644	2587	11231	0.00055
Jatrophihabitans	1434010	G	8425	805	9230	0.00045
Stackebrandtia	283810	G	7063	706	7769	0.00038
Natronoglycomyces	2838311	G	905	36	941	0.00005
Epidermidibacterium	2078948	G	4160	2135	6295	0.00031
Actinopolyspora	1849	G	3709	413	4122	0.00020
Acidothermus	28048	G	2047	118	2165	0.00011
Candidatus Planktophila	622681	G	365	54	419	0.00002
Rubrobacter	42255	G	369743	16326	386069	0.01875
Baekduia	2600304	G	90053	16656	106709	0.00518
Conexibacter	191494	G	308999	50181	359180	0.01744
Miltoncostaea	2843200	G	43708	6220	49928	0.00242
Aquihabitans	1648491	G	52099	9337	61436	0.00298
Iamia	467975	G	36270	6043	42313	0.00205
Actinomarinicola	2789775	G	25322	5237	30559	0.00148
Ilumatobacter	682522	G	11727	763	12490	0.00061
Acidimicrobium	53634	G	2692	221	2913	0.00014
Eggerthella	84111	G	4272	1399	5671	0.00028
Gordonibacter	644652	G	2316	972	3288	0.00016
Arabiibacter	2005386	G	1905	375	2280	0.00011
Adlercreutzia	447020	G	1863	418	2281	0.00011
Raoultibacter	1926677	G	836	69	905	0.00004
Berryella	2815775	G	707	841	1548	0.00008
Slackia	84108	G	611	20	631	0.00003
Denitrobacterium	79603	G	344	153	497	0.00002
Olsenella	133925	G	3186	566	3752	0.00018
Parolsenella	2082587	G	1878	590	2468	0.00012
Thermophilibacter	2847307	G	1058	358	1416	0.00007
Parafannyhessea	2847312	G	970	569	1539	0.00007
Atopobium	1380	G	243	25	268	0.00001
Collinsella	102106	G	2571	732	3303	0.00016
Coriobacterium	33870	G	633	22	655	0.00003
Euzebya	908623	G	7787	690	8477	0.00041
Egicoccus	1755825	G	7472	1241	8713	0.00042
Egibacter	1747770	G	7368	472	7840	0.00038
Paenibacillus	44249	G	35840	3968	39808	0.00193
Brevibacillus	55080	G	3864	870	4734	0.00023
Cohnella	329857	G	2581	404	2985	0.00014
Thermobacillus	76632	G	1887	268	2155	0.00010
Saccharibacillus	456492	G	1427	183	1610	0.00008
Aneurinibacillus	55079	G	228	59	287	0.00001
Bacillus	1386	G	10976	32953	43929	0.00213
Geobacillus	129337	G	2655	1049	3704	0.00018
Metabacillus	2675233	G	2548	1204	3752	0.00018
Lysinibacillus	400634	G	2191	966	3157	0.00015
Hydrogenibacillus	1609627	G	1988	335	2323	0.00011
Priestia	2800373	G	1885	3759	5644	0.00027
Peribacillus	2675229	G	1510	1008	2518	0.00012
Anoxybacillus	150247	G	1224	418	1642	0.00008
Cytobacillus	2675230	G	1208	589	1797	0.00009
Mesobacillus	2675231	G	615	228	843	0.00004
Fictibacillus	1329200	G	586	120	706	0.00003
Neobacillus	2675232	G	577	295	872	0.00004
Parageobacillus	1906945	G	560	224	784	0.00004
Virgibacillus	84406	G	493	88	581	0.00003
Oceanobacillus	182709	G	467	118	585	0.00003
Psychrobacillus	1221880	G	466	405	871	0.00004
Terribacillus	459532	G	460	93	553	0.00003
Alkalihalobacillus	2675234	G	384	104	488	0.00002
Rossellomorea	2837508	G	372	193	565	0.00003
Niallia	2837506	G	367	125	492	0.00002
Pradoshia	2651279	G	313	128	441	0.00002
Halobacillus	45667	G	312	52	364	0.00002
Weizmannia	2817139	G	296	166	462	0.00002
Salicibibacter	2685905	G	292	20	312	0.00002
Salisediminibacterium	1434042	G	248	44	292	0.00001
Heyndrickxia	2837504	G	230	101	331	0.00002
Sutcliffiella	2837511	G	226	103	329	0.00002
Gracilibacillus	74385	G	151	23	174	0.00001
Lentibacillus	175304	G	130	11	141	0.00001
Caldibacillus	1276290	G	127	67	194	0.00001
Mangrovibacillus	2920444	G	122	90	212	0.00001
Gottfriedia	2837503	G	120	48	168	0.00001
Lederbergia	2804231	G	106	36	142	0.00001
Alicyclobacillus	29330	G	2930	262	3192	0.00016
Tumebacillus	432330	G	2084	838	2922	0.00014
Kyrpidia	1129704	G	864	55	919	0.00004
Effusibacillus	1502725	G	137	20	157	0.00001
Planococcus	1372	G	2730	980	3710	0.00018
Solibacillus	648800	G	1839	972	2811	0.00014
Sporosarcina	1569	G	688	199	887	0.00004
Ureibacillus	160795	G	140	149	289	0.00001
Kurthia	1649	G	115	63	178	0.00001
Paenisporosarcina	651660	G	107	56	163	0.00001
Staphylospora	2689589	G	462	81	543	0.00003
Kroppenstedtia	1274351	G	456	47	503	0.00002
Novibacillus	1677050	G	301	53	354	0.00002
Polycladomyces	1348505	G	237	23	260	0.00001
Laceyella	292635	G	169	42	211	0.00001
Thermoactinomyces	2023	G	108	24	132	0.00001
Staphylococcus	1279	G	922	1236	2158	0.00010
Macrococcus	69965	G	175	69	244	0.00001
Jeotgalicoccus	227979	G	110	19	129	0.00001
Exiguobacterium	33986	G	1372	534	1906	0.00009
Listeria	1637	G	332	143	475	0.00002
Sporolactobacillus	2077	G	113	20	133	0.00001
Limosilactobacillus	2742598	G	563	366	929	0.00005
Lactobacillus	1578	G	437	453	890	0.00004
Levilactobacillus	2767886	G	404	122	526	0.00003
Lacticaseibacillus	2759736	G	376	141	517	0.00003
Schleiferilactobacillus	2767891	G	219	26	245	0.00001
Lactiplantibacillus	2767842	G	202	53	255	0.00001
Ligilactobacillus	2767887	G	141	95	236	0.00001
Weissella	46255	G	141	35	176	0.00001
Lentilactobacillus	2767893	G	120	36	156	0.00001
Leuconostoc	1243	G	117	20	137	0.00001
Streptococcus	1301	G	1041	1123	2164	0.00011
Lactococcus	1357	G	142	74	216	0.00001
Enterococcus	1350	G	574	1026	1600	0.00008
Vagococcus	2737	G	140	123	263	0.00001
Carnobacterium	2747	G	108	40	148	0.00001
Aerococcus	1375	G	122	48	170	0.00001
Thermaerobacter	73918	G	8339	669	9008	0.00044
Intestinimonas	1392389	G	612	235	847	0.00004
Flintibacter	1918454	G	381	41	422	0.00002
Aminipila	2060094	G	120	9	129	0.00001
Emergencia	1926556	G	110	39	149	0.00001
Massilistercora	2717089	G	158	139	297	0.00001
Carboxydocella	178898	G	118	13	131	0.00001
Faecalibacterium	216851	G	2281	1514	3795	0.00018
Dysosmobacter	2591381	G	1373	578	1951	0.00009
Flavonifractor	946234	G	1312	316	1628	0.00008
Ruthenibacterium	1905344	G	629	177	806	0.00004
Vescimonas	2892396	G	610	628	1238	0.00006
Ethanoligenens	253238	G	482	25	507	0.00002
Oscillibacter	459786	G	416	130	546	0.00003
Anaerotruncus	244127	G	392	196	588	0.00003
Caproiciproducens	1738645	G	380	41	421	0.00002
Acutalibacter	1918385	G	345	16	361	0.00002
Ruminococcus	1263	G	274	11	285	0.00001
Caproicibacter	2576755	G	274	15	289	0.00001
Pusillibacter	2892397	G	237	163	400	0.00002
Caproicibacterium	2834348	G	139	9	148	0.00001
Solibaculum	2842531	G	122	102	224	0.00001
Symbiobacterium	2733	G	3198	280	3478	0.00017
Lachnoclostridium	1506553	G	526	297	823	0.00004
Blautia	572511	G	418	644	1062	0.00005
Roseburia	841	G	220	187	407	0.00002
Enterocloster	2719313	G	208	130	338	0.00002
Coprococcus	33042	G	123	95	218	0.00001
Anaerostipes	207244	G	123	38	161	0.00001
Lacrimispora	2719231	G	103	8	111	0.00001
Clostridium	1485	G	1486	416	1902	0.00009
Hungatella	1649459	G	208	8	216	0.00001
Candidatus Desulforudis	471826	G	867	59	926	0.00004
Desulforamulus	2916693	G	261	61	322	0.00002
Acididesulfobacillus	2924872	G	228	9	237	0.00001
Candidatus Formimonas	2840454	G	127	9	136	0.00001
Christensenella	990721	G	999	507	1506	0.00007
Heliomicrobium	2831443	G	811	336	1147	0.00006
Desulfitobacterium	36853	G	286	59	345	0.00002
Desulfosporosinus	79206	G	238	27	265	0.00001
Dehalobacter	56112	G	112	15	127	0.00001
Eubacterium	1730	G	471	111	582	0.00003
Acetobacterium	33951	G	155	22	177	0.00001
Romboutsia	1501226	G	136	61	197	0.00001
Syntrophothermus	129001	G	106	8	114	0.00001
Desulfoscipio	2867376	G	153	13	166	0.00001
Desulfotomaculum	1562	G	100	39	139	0.00001
Moorella	44260	G	1171	50	1221	0.00006
Ammonifex	42837	G	473	18	491	0.00002
Gelria	189326	G	1079	85	1164	0.00006
Thermacetogenium	140458	G	406	354	760	0.00004
Carboxydothermus	129957	G	178	17	195	0.00001
Thermanaeromonas	202949	G	113	3	116	0.00001
Thermoanaerobacter	1754	G	103	36	139	0.00001
Caldicellulosiruptor	44000	G	126	19	145	0.00001
Zhaonella	2748674	G	110	16	126	0.00001
Thermosediminibacter	291988	G	234	15	249	0.00001
Selenomonas	970	G	3160	192	3352	0.00016
Sporomusa	2375	G	183	21	204	0.00001
Methylomusa	2093783	G	134	8	142	0.00001
Megasphaera	906	G	858	353	1211	0.00006
Dialister	39948	G	111	3	114	0.00001
Acidaminococcus	904	G	287	41	328	0.00002
Phascolarctobacterium	33024	G	182	51	233	0.00001
Limnochorda	1676651	G	3470	144	3614	0.00018
Allobaculum	174708	G	183	23	206	0.00001
Faecalibaculum	1729679	G	145	26	171	0.00001
Peptoniphilus	162289	G	165	63	228	0.00001
Ndongobacter	1930845	G	106	120	226	0.00001
Synechococcus	1129	G	15892	1540	17432	0.00085
Cyanobium	167375	G	3733	722	4455	0.00022
Parasynechococcus	2881427	G	218	53	271	0.00001
Prochlorococcus	1218	G	191	9	200	0.00001
Acaryochloris	155977	G	257	6	263	0.00001
Chamaesiphon	217161	G	227	9	236	0.00001
Synechocystis	1142	G	193	132	325	0.00002
Nostoc	1177	G	5563	621	6184	0.00030
Anabaena	1163	G	308	1111	1419	0.00007
Cylindrospermum	56106	G	294	23	317	0.00002
Trichormus	264688	G	111	40	151	0.00001
Richelia	98443	G	107	9	116	0.00001
Scytonema	1203	G	5351	613	5964	0.00029
Brasilonema	383614	G	438	31	469	0.00002
Calothrix	1186	G	2350	195	2545	0.00012
Sphaerospermopsis	752201	G	294	44	338	0.00002
Nodularia	159191	G	276	34	310	0.00002
Anabaenopsis	110103	G	184	69	253	0.00001
Dolichospermum	748770	G	159	436	595	0.00003
Fischerella	1190	G	472	52	524	0.00003
Tolypothrix	111782	G	420	72	492	0.00002
Rivularia	373984	G	131	6	137	0.00001
Microcoleus	44471	G	1356	209	1565	0.00008
Oxynema	1492710	G	422	28	450	0.00002
Oscillatoria	1158	G	933	167	1100	0.00005
Moorena	1155738	G	607	11	618	0.00003
Geitlerinema	63132	G	861	95	956	0.00005
Allocoleopsis	2886347	G	421	33	454	0.00002
Koinonema	2023214	G	265	12	277	0.00001
Crinalium	241421	G	151	14	165	0.00001
Gloeothece	28070	G	121	9	130	0.00001
Microcystis	1125	G	354	80	434	0.00002
Gloeocapsa	102231	G	178	14	192	0.00001
Geminocystis	669357	G	112	17	129	0.00001
Leptolyngbya	47251	G	3452	225	3677	0.00018
Kovacikia	1874526	G	505	34	539	0.00003
Leptothermofonsia	2917830	G	282	24	306	0.00001
Leptodesmis	2664261	G	213	20	233	0.00001
Thermoleptolyngbya	2303528	G	660	51	711	0.00003
Halomicronema	170610	G	414	13	427	0.00002
Thermosynechococcus	146785	G	354	26	380	0.00002
Pseudanabaena	1152	G	227	8	235	0.00001
Gloeobacter	33071	G	4880	108	4988	0.00024
Anthocerotibacter	2857076	G	361	9	370	0.00002
Chroococcidiopsis	54298	G	1565	166	1731	0.00008
Pleurocapsa	44474	G	155	15	170	0.00001
Gloeomargarita	1188227	G	122	3	125	0.00001
Deinococcus	1298	G	37217	3533	40750	0.00198
Thermus	270	G	6305	494	6799	0.00033
Meiothermus	65551	G	3039	198	3237	0.00016
Oceanithermus	208447	G	3014	315	3329	0.00016
Marinithermus	186191	G	1886	282	2168	0.00011
Truepera	332248	G	3007	161	3168	0.00015
Sphaerobacter	2056	G	9666	527	10193	0.00049
Thermomicrobium	499	G	1988	38	2026	0.00010
Roseiflexus	120961	G	4629	248	4877	0.00024
Chloroflexus	1107	G	1821	73	1894	0.00009
Candidatus Promineofilum	1988031	G	4407	91	4498	0.00022
Tepidiforma	2682228	G	4290	185	4475	0.00022
Caldilinea	233191	G	2004	111	2115	0.00010
Dehalogenimonas	670486	G	916	34	950	0.00005
Dehalococcoides	61434	G	328	16	344	0.00002
Anaerolinea	233189	G	595	34	629	0.00003
Pelolinea	1649478	G	480	12	492	0.00002
Brevefilum	2019482	G	170	3	173	0.00001
Thermobaculum	262406	G	1002	120	1122	0.00005
Ktedonosporobacter	2692417	G	943	24	967	0.00005
Phototrophicus	2922426	G	594	5	599	0.00003
Fimbriimonas	1005038	G	2097	13	2110	0.00010
Chthonomonas	1077265	G	438	4	442	0.00002
Mycoplasma	2093	G	132	90	222	0.00001
Spiroplasma	2132	G	107	21	128	0.00001
Bradyrhizobium	374	G	531877	62936	594813	0.02888
Rhodopseudomonas	1073	G	35330	9456	44786	0.00217
Tardiphaga	1395974	G	12548	1628	14176	0.00069
Variibacter	1649510	G	8885	669	9554	0.00046
Nitrobacter	911	G	8279	1010	9289	0.00045
Afipia	1033	G	8236	2757	10993	0.00053
Microvirga	186650	G	289462	32592	322054	0.01564
Methylobacterium	407	G	224218	42466	266684	0.01295
Methylorubrum	2282523	G	42628	19070	61698	0.00300
Rhizobium	379	G	113362	53707	167069	0.00811
Agrobacterium	357	G	23939	7872	31811	0.00154
Neorhizobium	1525371	G	13962	3077	17039	0.00083
Pseudorhizobium	1903858	G	4218	747	4965	0.00024
Sinorhizobium	28105	G	37501	15052	52553	0.00255
Ensifer	106591	G	24241	4481	28722	0.00139
Shinella	323620	G	21320	14759	36079	0.00175
Ciceribacter	1648508	G	2702	508	3210	0.00016
Georhizobium	2661800	G	2570	533	3103	0.00015
Peteryoungia	2853332	G	877	146	1023	0.00005
Mesorhizobium	68287	G	172515	32489	205004	0.00995
Aquibium	2911176	G	13830	3318	17148	0.00083
Aminobacter	31988	G	10374	6877	17251	0.00084
Nitratireductor	245876	G	8757	1310	10067	0.00049
Phyllobacterium	28100	G	5241	528	5769	0.00028
Roseitalea	1915401	G	3993	666	4659	0.00023
Hoeflea	274591	G	2941	275	3216	0.00016
Oricola	1594166	G	2937	397	3334	0.00016
Salaquimonas	2712688	G	1010	45	1055	0.00005
Pseudolabrys	556257	G	25962	3821	29783	0.00145
Xanthobacter	279	G	18158	4117	22275	0.00108
Starkeya	152053	G	16984	4394	21378	0.00104
Ancylobacter	99	G	16111	5466	21577	0.00105
Labrys	204476	G	6423	663	7086	0.00034
Azorhizobium	6	G	5858	1238	7096	0.00034
Bosea	85413	G	69715	10570	80285	0.00390
Rhodoplanes	29407	G	36018	3448	39466	0.00192
Hyphomicrobium	81	G	11855	823	12678	0.00062
Methyloceanibacter	1484898	G	5151	368	5519	0.00027
Aquabacter	45402	G	5123	831	5954	0.00029
Methyloligella	1485594	G	3292	406	3698	0.00018
Rhodomicrobium	1068	G	2867	203	3070	0.00015
Caenibius	2827482	G	2094	935	3029	0.00015
Filomicrobium	119044	G	1120	34	1154	0.00006
Devosia	46913	G	44289	3480	47769	0.00232
Youhaiella	1827478	G	4203	892	5095	0.00025
Paradevosia	1573407	G	3853	1395	5248	0.00025
Pelagibacterium	1082930	G	1852	241	2093	0.00010
Maritalea	623276	G	364	13	377	0.00002
Aureimonas	414371	G	25259	5007	30266	0.00147
Martelella	293088	G	11118	2020	13138	0.00064
Aurantimonas	182269	G	7149	2110	9259	0.00045
Nordella	169055	G	10794	585	11379	0.00055
Pseudorhodoplanes	1734920	G	10577	759	11336	0.00055
Terrihabitans	2874214	G	9475	1037	10512	0.00051
Phreatobacter	1632780	G	28060	4848	32908	0.00160
Methylocystis	133	G	17205	1530	18735	0.00091
Methylosinus	425	G	8706	1299	10005	0.00049
Stappia	152161	G	9612	1830	11442	0.00056
Pannonibacter	227873	G	4414	2997	7411	0.00036
Roseibium	150830	G	4286	548	4834	0.00023
Labrenzia	478070	G	3307	291	3598	0.00017
Pseudovibrio	258255	G	735	42	777	0.00004
Chelatococcus	28209	G	21156	4671	25827	0.00125
Blastochloris	59282	G	13887	3301	17188	0.00083
Kaustia	2838250	G	7498	733	8231	0.00040
Parvibaculum	256616	G	2817	1959	4776	0.00023
Pyruvatibacter	1742974	G	2039	260	2299	0.00011
Candidatus Phaeomarinobacter	1541445	G	762	40	802	0.00004
Methylocella	120652	G	6110	548	6658	0.00032
Methylovirgula	1156568	G	4834	397	5231	0.00025
Beijerinckia	532	G	1356	103	1459	0.00007
Acuticoccus	1904377	G	9090	1018	10108	0.00049
Kaistia	166953	G	7923	1949	9872	0.00048
Brucella	234	G	5894	5294	11188	0.00054
Pseudochrobactrum	354349	G	614	113	727	0.00004
Hartmannibacter	1572860	G	5000	881	5881	0.00029
Lichenihabitans	2723776	G	4995	251	5246	0.00025
Breoghania	1406135	G	4670	618	5288	0.00026
Cohaesibacter	655352	G	808	35	843	0.00004
Bartonella	773	G	569	38	607	0.00003
Sphingomonas	13687	G	287952	42415	330367	0.01604
Sphingobium	165695	G	52400	25939	78339	0.00380
Sphingopyxis	165697	G	51084	10591	61675	0.00299
Novosphingobium	165696	G	39260	14004	53264	0.00259
Rhizorhabdus	1649486	G	18242	8645	26887	0.00131
Allosphingosinicella	2823232	G	9752	1225	10977	0.00053
Sphingosinithalassobacter	2676233	G	6774	1552	8326	0.00040
Parasphingopyxis	1234545	G	4248	223	4471	0.00022
Sphingorhabdus	1434046	G	3763	267	4030	0.00020
Blastomonas	150203	G	3465	651	4116	0.00020
Hankyongella	1763827	G	2486	468	2954	0.00014
Tardibacter	2685927	G	2294	1714	4008	0.00019
Citromicrobium	72173	G	2133	922	3055	0.00015
Novosphingopyxis	2709686	G	1624	853	2477	0.00012
Parasphingorhabdus	2709685	G	992	34	1026	0.00005
Aquisediminimonas	2676781	G	909	39	948	0.00005
Erythrobacter	1041	G	23033	5804	28837	0.00140
Porphyrobacter	1111	G	7405	2088	9493	0.00046
Qipengyuania	1855416	G	15141	3924	19065	0.00093
Tsuneonella	2800686	G	8840	1802	10642	0.00052
Altererythrobacter	361177	G	8661	2271	10932	0.00053
Croceicoccus	1295327	G	8216	4905	13121	0.00064
Pelagerythrobacter	2800685	G	1683	240	1923	0.00009
Aurantiacibacter	2800681	G	1661	271	1932	0.00009
Paraurantiacibacter	2800682	G	1533	206	1739	0.00008
Croceibacterium	2676755	G	1355	556	1911	0.00009
Sphingosinicella	335405	G	22410	2309	24719	0.00120
Polymorphobacter	1508451	G	6194	252	6446	0.00031
Sandaracinobacter	56358	G	2623	187	2810	0.00014
Zymomonas	541	G	170	176	346	0.00002
Roseomonas	125216	G	105774	17566	123340	0.00599
Roseococcus	35812	G	13649	1353	15002	0.00073
Rhodovastum	504465	G	12786	1368	14154	0.00069
Sediminicoccus	1706033	G	8646	476	9122	0.00044
Acidiphilium	522	G	6695	4178	10873	0.00053
Komagataeibacter	1434011	G	6444	3473	9917	0.00048
Lichenicola	2804525	G	4750	247	4997	0.00024
Acidibrevibacterium	2603324	G	3859	352	4211	0.00020
Acetobacter	434	G	3250	1308	4558	0.00022
Gluconacetobacter	89583	G	2512	577	3089	0.00015
Gluconobacter	441	G	2299	667	2966	0.00014
Granulibacter	364409	G	1515	152	1667	0.00008
Neoasaia	320496	G	971	220	1191	0.00006
Asaia	91914	G	967	184	1151	0.00006
Kozakia	153497	G	706	278	984	0.00005
Novacetimonas	2919364	G	644	347	991	0.00005
Oecophyllibacter	2791118	G	495	18	513	0.00002
Parasaccharibacter	1602345	G	314	18	332	0.00002
Swingsia	1649499	G	227	12	239	0.00001
Neokomagataea	1223423	G	112	20	132	0.00001
Azospirillum	191	G	78229	10395	88624	0.00430
Skermanella	204447	G	50435	7768	58203	0.00283
Nitrospirillum	1543705	G	5302	603	5905	0.00029
Indioceanicola	2478349	G	4648	626	5274	0.00026
Niveispirillum	1543704	G	2011	217	2228	0.00011
Hypericibacter	2705399	G	17837	1132	18969	0.00092
Magnetospirillum	13134	G	11848	231251	243099	0.01180
Rhodospirillum	1081	G	8229	1039	9268	0.00045
Tistrella	171436	G	5278	2375	7653	0.00037
Ferrovibrio	1231242	G	3991	263	4254	0.00021
Defluviicoccus	111830	G	3106	293	3399	0.00017
Pararhodospirillum	1612157	G	1673	138	1811	0.00009
Haematospirillum	1804663	G	259	25	284	0.00001
Stella	93	G	11958	870	12828	0.00062
Elioraea	457933	G	7503	409	7912	0.00038
Thalassospira	168934	G	1908	178	2086	0.00010
Magnetospira	1182780	G	1012	37	1049	0.00005
Terasakiella	196080	G	148	4	152	0.00001
Paracoccus	265	G	70555	10723	81278	0.00395
Cereibacter	1653176	G	13034	3775	16809	0.00082
Rhodobacter	1060	G	12111	3573	15684	0.00076
Rhodovulum	34008	G	6453	1408	7861	0.00038
Paroceanicella	2683599	G	5322	1288	6610	0.00032
Polymorphum	991903	G	4953	1249	6202	0.00030
Pontivivens	1844015	G	3554	268	3822	0.00019
Pikeienuella	2831955	G	3280	313	3593	0.00017
Pelagovum	2795377	G	3264	391	3655	0.00018
Thioclava	285107	G	3248	369	3617	0.00018
Silicimonas	1955420	G	3209	182	3391	0.00016
Frigidibacter	1775705	G	2726	1088	3814	0.00019
Brevirhabdus	1855413	G	2076	858	2934	0.00014
Pukyongiella	2831925	G	2058	435	2493	0.00012
Falsirhodobacter	1434002	G	1744	238	1982	0.00010
Fuscovulum	2818469	G	1736	203	1939	0.00009
Gymnodinialimonas	2937410	G	1704	152	1856	0.00009
Gemmobacter	204456	G	1567	326	1893	0.00009
Haematobacter	366614	G	1559	600	2159	0.00010
Pseudopuniceibacterium	2613960	G	1528	112	1640	0.00008
Tabrizicola	1443919	G	1503	125	1628	0.00008
Pacificitalea	2846749	G	1378	267	1645	0.00008
Pseudooceanicola	1679449	G	1262	116	1378	0.00007
Roseicitreum	1209946	G	1088	53	1141	0.00006
Monaibacterium	2029873	G	1032	210	1242	0.00006
Tritonibacter	2083206	G	833	321	1154	0.00006
Yoonia	2211641	G	759	148	907	0.00004
Qingshengfaniella	2816884	G	685	36	721	0.00004
Rhodophyticola	2680018	G	678	19	697	0.00003
Pseudohalocynthiibacter	1759417	G	641	110	751	0.00004
Pseudorhodobacter	238783	G	494	30	524	0.00003
Rhodobaca	119541	G	487	21	508	0.00002
Profundibacter	2778525	G	477	16	493	0.00002
Parasedimentitalea	2738399	G	411	19	430	0.00002
Aestuarium	2820509	G	337	118	455	0.00002
Cognatishimia	2211635	G	331	14	345	0.00002
Planktomarina	1284657	G	216	5	221	0.00001
Roseovarius	74030	G	11786	1617	13403	0.00065
Sulfitobacter	60136	G	10504	1888	12392	0.00060
Salipiger	263377	G	9059	2687	11746	0.00057
Roseivivax	93682	G	7101	976	8077	0.00039
Celeribacter	875170	G	4632	1597	6229	0.00030
Leisingera	191028	G	3945	503	4448	0.00022
Phaeobacter	302485	G	3894	706	4600	0.00022
Ruegeria	97050	G	3544	468	4012	0.00019
Yangia	2919626	G	3207	509	3716	0.00018
Sagittula	58842	G	3136	1150	4286	0.00021
Pseudosulfitobacter	2854186	G	2979	712	3691	0.00018
Ponticoccus	983507	G	2415	334	2749	0.00013
Mameliella	1434019	G	2312	383	2695	0.00013
Dinoroseobacter	309512	G	2030	639	2669	0.00013
Roseobacter	2433	G	1757	45	1802	0.00009
Oceanicola	252301	G	1686	82	1768	0.00009
Ketogulonicigenium	92944	G	1619	193	1812	0.00009
Actibacterium	1433986	G	1597	668	2265	0.00011
Roseibacterium	159345	G	1572	127	1699	0.00008
Octadecabacter	53945	G	1486	89	1575	0.00008
Maribius	387095	G	1175	59	1234	0.00006
Tateyamaria	299261	G	1080	33	1113	0.00005
Antarctobacter	74032	G	1016	48	1064	0.00005
Jannaschia	188905	G	1015	25	1040	0.00005
Thalassococcus	436357	G	982	23	1005	0.00005
Thalassobius	335927	G	534	27	561	0.00003
Falsihalocynthiibacter	2854182	G	228	6	234	0.00001
Caulobacter	75	G	59846	7726	67572	0.00328
Brevundimonas	41275	G	52539	7884	60423	0.00293
Phenylobacterium	20	G	23449	4014	27463	0.00133
Terricaulis	2768684	G	3804	135	3939	0.00019
Asticcacaulis	76890	G	3286	261	3547	0.00017
Marinicauda	1649466	G	3503	604	4107	0.00020
Maricaulis	74317	G	1084	72	1156	0.00006
Glycocaulis	1433402	G	967	51	1018	0.00005
Hyphobacterium	2004661	G	743	33	776	0.00004
Hyphomonas	85	G	3721	181	3902	0.00019
Candidatus Viadribacter	2892997	G	2114	57	2171	0.00011
Aquisalinus	1795639	G	1374	67	1441	0.00007
Parvularcula	208215	G	562	68	630	0.00003
Paremcibacter	2813804	G	408	14	422	0.00002
Luteithermobacter	2813803	G	403	80	483	0.00002
Anaplasma	768	G	133	20	153	0.00001
Wolbachia	953	G	106	6	112	0.00001
Rickettsia	780	G	248	21	269	0.00001
Micavibrio	213485	G	553	8	561	0.00003
Candidatus Puniceispirillum	767891	G	111	3	114	0.00001
Magnetococcus	162171	G	221	38	259	0.00001
Kordiimonas	288021	G	119	2	121	0.00001
Burkholderia	32008	G	156616	125099	281715	0.01368
Cupriavidus	106589	G	87847	27144	114991	0.00558
Paraburkholderia	1822464	G	72118	7448	79566	0.00386
Ralstonia	48736	G	23407	29699	53106	0.00258
Pandoraea	93217	G	20592	3278	23870	0.00116
Caballeronia	1827195	G	19495	2254	21749	0.00106
Lautropia	47670	G	2110	375	2485	0.00012
Polynucleobacter	44013	G	1854	53	1907	0.00009
Chitinimonas	240411	G	1286	97	1383	0.00007
Mycetohabitans	2571159	G	1004	67	1071	0.00005
Mycoavidus	1810868	G	336	15	351	0.00002
Candidatus Vallotia	2018044	G	215	28	243	0.00001
Limnobacter	131079	G	183	9	192	0.00001
Ephemeroptericola	2680021	G	105	7	112	0.00001
Variovorax	34072	G	103036	37253	140289	0.00681
Hydrogenophaga	47420	G	39043	18405	57448	0.00279
Acidovorax	12916	G	37004	19218	56222	0.00273
Ramlibacter	174951	G	27101	10707	37808	0.00184
Comamonas	283	G	20896	11524	32420	0.00157
Rhodoferax	28065	G	17364	4152	21516	0.00104
Schlegelella	215579	G	14210	4148	18358	0.00089
Diaphorobacter	238749	G	11017	11535	22552	0.00110
Delftia	80865	G	10974	14958	25932	0.00126
Kinneretia	683756	G	8606	5091	13697	0.00067
Polaromonas	52972	G	8464	583	9047	0.00044
Ottowia	219181	G	6247	1050	7297	0.00035
Alicycliphilus	201096	G	5663	9205	14868	0.00072
Melaminivora	1649468	G	4651	4448	9099	0.00044
Serpentinimonas	2490452	G	3170	777	3947	0.00019
Verminephrobacter	364316	G	2779	327	3106	0.00015
Hylemonella	232523	G	2214	298	2512	0.00012
Pulveribacter	2678886	G	2207	1088	3295	0.00016
Simplicispira	352450	G	1561	622	2183	0.00011
Limnohabitans	665874	G	1001	93	1094	0.00005
Curvibacter	281915	G	742	51	793	0.00004
Candidatus Symbiobacter	1436289	G	635	23	658	0.00003
Massilia	149698	G	129519	21742	151261	0.00734
Duganella	75654	G	8829	2770	11599	0.00056
Janthinobacterium	29580	G	16472	3957	20429	0.00099
Herbaspirillum	963	G	15576	2672	18248	0.00089
Collimonas	202907	G	6345	663	7008	0.00034
Noviherbaspirillum	1344552	G	3806	585	4391	0.00021
Undibacterium	401469	G	842	51	893	0.00004
Herminiimonas	303379	G	344	41	385	0.00002
Glaciimonas	1229970	G	321	19	340	0.00002
Oxalobacter	846	G	147	14	161	0.00001
Achromobacter	222	G	49757	21503	71260	0.00346
Bordetella	517	G	43095	35008	78103	0.00379
Pigmentiphaga	152267	G	7024	731	7755	0.00038
Orrella	1921582	G	3367	1015	4382	0.00021
Castellaniella	359336	G	3067	2107	5174	0.00025
Alcaligenes	507	G	1876	457	2333	0.00011
Pusillimonas (ex Stolz et al. 2005)	305976	G	1302	273	1575	0.00008
Paralcaligenes	1148163	G	842	32	874	0.00004
Kerstersia	257820	G	824	165	989	0.00005
Advenella	290425	G	654	20	674	0.00003
Oligella	90243	G	116	50	166	0.00001
Rhizobacter	212743	G	21566	4500	26066	0.00127
Sphaerotilus	34102	G	11330	5764	17094	0.00083
Methylibium	316612	G	9181	2689	11870	0.00058
Rubrivivax	28067	G	9129	2832	11961	0.00058
Aquincola	391952	G	8495	2904	11399	0.00055
Leptothrix	88	G	6240	1928	8168	0.00040
Mitsuaria	65047	G	6123	1201	7324	0.00036
Thiomonas	32012	G	5729	1139	6868	0.00033
Xylophilus	54066	G	4837	1323	6160	0.00030
Ideonella	36862	G	3492	1997	5489	0.00027
Aquabacterium	92793	G	2885	731	3616	0.00018
Roseateles	93681	G	2838	532	3370	0.00016
Tepidimonas	114248	G	2806	1006	3812	0.00019
Inhella	644355	G	1925	298	2223	0.00011
Paucibacter	318147	G	1621	259	1880	0.00009
Sutterella	40544	G	1916	192	2108	0.00010
Thauera	33057	G	16609	10508	27117	0.00132
Azoarcus	12960	G	14415	4503	18918	0.00092
Nitrogeniibacter	2891294	G	4605	712	5317	0.00026
Aromatoleum	551759	G	12902	3779	16681	0.00081
Azospira	146937	G	8806	3950	12756	0.00062
Niveibacterium	1769726	G	2289	331	2620	0.00013
Oryzomicrobium	1911577	G	1777	419	2196	0.00011
Rugosibacter	1914449	G	366	59	425	0.00002
Dechloromonas	73029	G	3932	657	4589	0.00022
Ferribacterium	88875	G	3259	521	3780	0.00018
Quatrionicoccus	138117	G	1362	370	1732	0.00008
Fluviibacter	2808942	G	202	80	282	0.00001
Usitatibacter	2803845	G	23876	1836	25712	0.00125
Denitratisoma	311181	G	3252	1494	4746	0.00023
Methyloversatilis	378210	G	2319	293	2612	0.00013
Sulfuritalea	1054211	G	2318	310	2628	0.00013
Sterolibacterium	157591	G	1562	430	1992	0.00010
Nitrosospira	35798	G	6680	187	6867	0.00033
Nitrosomonas	914	G	1599	142	1741	0.00008
Thiobacillus	919	G	3058	589	3647	0.00018
Sulfuritortus	1938335	G	2221	877	3098	0.00015
Sideroxydans	314343	G	1992	256	2248	0.00011
Ferrigenium	2249462	G	1279	247	1526	0.00007
Ferriphaselus	1443590	G	462	59	521	0.00003
Candidatus Nitrotoga	453161	G	414	24	438	0.00002
Gallionella	96	G	352	30	382	0.00002
Sulfurimicrobium	2772198	G	1558	182	1740	0.00008
Sulfuriferula	1778653	G	1438	218	1656	0.00008
Sulfuricella	935200	G	750	65	815	0.00004
Methylovorus	81682	G	444	30	474	0.00002
Methylobacillus	404	G	412	98	510	0.00002
Methylophilus	16	G	216	12	228	0.00001
Methylotenera	359407	G	155	11	166	0.00001
Candidatus Methylopumilus	1679002	G	141	9	150	0.00001
Chromobacterium	535	G	14331	3026	17357	0.00084
Iodobacter	32014	G	184	41	225	0.00001
Jeongeupia	885864	G	3794	658	4452	0.00022
Paludibacterium	400060	G	3184	527	3711	0.00018
Pseudogulbenkiania	568394	G	2383	735	3118	0.00015
Vogesella	57739	G	2277	520	2797	0.00014
Aquitalea	407217	G	1801	317	2118	0.00010
Microvirgula	57479	G	1626	287	1913	0.00009
Laribacter	168470	G	1149	1098	2247	0.00011
Aquaspirillum	187	G	791	108	899	0.00004
Chitinibacter	230666	G	299	129	428	0.00002
Deefgea	400947	G	264	31	295	0.00001
Neisseria	482	G	4770	1732	6502	0.00032
Crenobacter	1654931	G	2747	844	3591	0.00017
Chitinolyticbacter	1055692	G	1839	207	2046	0.00010
Vitreoscilla	59	G	1010	156	1166	0.00006
Kingella	32257	G	647	189	836	0.00004
Eikenella	538	G	538	161	699	0.00003
Uruburuella	299568	G	488	76	564	0.00003
Paralysiella	2898489	G	182	35	217	0.00001
Casimicrobium	2706000	G	2074	977	3051	0.00015
Lysobacter	68	G	98476	15198	113674	0.00552
Stenotrophomonas	40323	G	43586	18949	62535	0.00304
Xanthomonas	338	G	40712	30944	71656	0.00348
Luteimonas	83614	G	27543	5472	33015	0.00160
Pseudoxanthomonas	83618	G	19357	8282	27639	0.00134
Thermomonas	141948	G	10670	2846	13516	0.00066
Arenimonas	490567	G	3463	678	4141	0.00020
Pseudolysobacter	2709666	G	1623	46	1669	0.00008
Xylella	2370	G	442	61	503	0.00002
Luteibacter	242605	G	13244	1461	14705	0.00071
Rhodanobacter	75309	G	9973	2114	12087	0.00059
Dyella	231454	G	8809	1438	10247	0.00050
Frateuria	70411	G	5813	1408	7221	0.00035
Dokdonella	323413	G	5116	893	6009	0.00029
Aerosticca	2707020	G	2314	3045	5359	0.00026
Ahniella	2233801	G	1273	35	1308	0.00006
Pseudomonas	286	G	296630	89505	386135	0.01875
Azotobacter	352	G	6923	3500	10423	0.00051
Halopseudomonas	2901189	G	3293	585	3878	0.00019
Permianibacter	1649479	G	515	17	532	0.00003
Marinobacter	2742	G	6703	551	7254	0.00035
Klebsiella	570	G	7939	75392	83331	0.00405
Raoultella	160674	G	2020	1419	3439	0.00017
Enterobacter	547	G	8897	21358	30255	0.00147
Citrobacter	544	G	3552	4052	7604	0.00037
Cronobacter	413496	G	2491	656	3147	0.00015
Leclercia	83654	G	2279	1373	3652	0.00018
Kosakonia	1330547	G	2079	410	2489	0.00012
Pluralibacter	1330546	G	1651	452	2103	0.00010
Salmonella	590	G	1595	51986	53581	0.00260
Escherichia	561	G	1239	31204	32443	0.00158
Cedecea	158483	G	1187	199	1386	0.00007
Lelliottia	1330545	G	740	171	911	0.00004
Kluyvera	579	G	696	233	929	0.00005
Candidatus Symbiopectobacterium	801	G	165	23	188	0.00001
Pseudescherichia	2055880	G	329	21	350	0.00002
Jejubacter	2815296	G	323	39	362	0.00002
Buttiauxella	82976	G	292	49	341	0.00002
Plesiomonas	702	G	276	101	377	0.00002
Atlantibacter	1903434	G	267	65	332	0.00002
Yokenella	158876	G	262	130	392	0.00002
Shimwellia	1335483	G	231	53	284	0.00001
Scandinavium	2726810	G	207	44	251	0.00001
Pseudocitrobacter	1504576	G	173	49	222	0.00001
Phytobacter	447792	G	170	393	563	0.00003
Serratia	613	G	13026	4142	17168	0.00083
Rahnella	34037	G	1211	326	1537	0.00007
Yersinia	629	G	1078	1609	2687	0.00013
Nissabacter	1964366	G	935	150	1085	0.00005
Gibbsiella	929812	G	480	68	548	0.00003
Ewingella	41201	G	261	39	300	0.00001
Rouxiella	1565532	G	230	22	252	0.00001
Chania	1745211	G	134	16	150	0.00001
Pantoea	53335	G	8821	2039	10860	0.00053
Erwinia	551	G	3432	681	4113	0.00020
Mixta	2100764	G	1918	604	2522	0.00012
Buchnera	32199	G	160	23	183	0.00001
Tatumella	82986	G	126	22	148	0.00001
Dickeya	204037	G	3617	771	4388	0.00021
Pectobacterium	122277	G	1918	385	2303	0.00011
Brenneria	71655	G	1296	123	1419	0.00007
Lonsdalea	1082702	G	569	102	671	0.00003
Musicola	2884243	G	325	15	340	0.00002
Edwardsiella	635	G	2136	919	3055	0.00015
Hafnia	568	G	249	100	349	0.00002
Morganella	581	G	505	587	1092	0.00005
Providencia	586	G	366	161	527	0.00003
Xenorhabdus	626	G	324	300	624	0.00003
Photorhabdus	29487	G	223	20	243	0.00001
Proteus	583	G	216	271	487	0.00002
Sodalis	84565	G	1475	113	1588	0.00008
Leminorella	82980	G	184	33	217	0.00001
Thioalkalivibrio	106633	G	9204	1602	10806	0.00052
Spiribacter	1335745	G	6325	445	6770	0.00033
Acidihalobacter	1765964	G	3911	319	4230	0.00021
Halorhodospira	85108	G	2213	183	2396	0.00012
Aquisalimonas	406099	G	1868	120	1988	0.00010
Alkalilimnicola	133193	G	1826	222	2048	0.00010
Ectothiorhodospira	1051	G	1554	147	1701	0.00008
Ectothiorhodosinus	233099	G	200	12	212	0.00001
Thiodictyon	53392	G	3574	183	3757	0.00018
Allochromatium	85072	G	3167	668	3835	0.00019
Marichromatium	85076	G	2972	557	3529	0.00017
Thioflavicoccus	156885	G	2962	271	3233	0.00016
Thiocapsa	1056	G	2300	117	2417	0.00012
Thiocystis	13724	G	1756	146	1902	0.00009
Thermochromatium	85073	G	997	210	1207	0.00006
Caldichromatium	2828366	G	771	88	859	0.00004
Nitrosococcus	1227	G	712	22	734	0.00004
Rheinheimera	67575	G	266	42	308	0.00001
Wenzhouxiangella	1676142	G	3154	156	3310	0.00016
Thiohalobacter	1273155	G	2267	259	2526	0.00012
Guyparkeria	2035712	G	1808	466	2274	0.00011
Sulfurivermis	2034504	G	1557	565	2122	0.00010
Halothiobacillus	109262	G	973	79	1052	0.00005
Woeseia	1738655	G	958	17	975	0.00005
Sulfuriflexus	1860077	G	380	11	391	0.00002
Granulosicoccus	437504	G	330	6	336	0.00002
Halomonas	2745	G	37235	6373	43608	0.00212
Cobetia	204286	G	2158	1308	3466	0.00017
Halotalea	376488	G	1978	395	2373	0.00012
Salinicola	404432	G	1933	235	2168	0.00011
Kushneria	504090	G	1392	79	1471	0.00007
Chromohalobacter	42054	G	1260	147	1407	0.00007
Pistricoccus	1897649	G	848	64	912	0.00004
Zymobacter	33073	G	198	28	226	0.00001
Alcanivorax	59753	G	4306	2274	6580	0.00032
Ketobacter	2025617	G	193	13	206	0.00001
Marinobacterium	48075	G	1295	157	1452	0.00007
Marinomonas	28253	G	407	41	448	0.00002
Thalassolituus	187492	G	271	31	302	0.00001
Venatorbacter	2893036	G	218	53	271	0.00001
Bacterioplanes	1537406	G	204	11	215	0.00001
Neptunomonas	75687	G	147	11	158	0.00001
Nitrincola	267849	G	100	15	115	0.00001
Hahella	158481	G	973	41	1014	0.00005
Saccharospirillum	231683	G	495	30	525	0.00003
Reinekea	230494	G	224	12	236	0.00001
Gynuella	1445504	G	152	4	156	0.00001
Litoricola	418700	G	342	18	360	0.00002
Endozoicomonas	305899	G	101	6	107	0.00001
Aeromonas	642	G	19713	14622	34335	0.00167
Zobellella	347533	G	1517	362	1879	0.00009
Oceanimonas	129577	G	662	145	807	0.00004
Dongshaea	2802288	G	160	16	176	0.00001
Oceanisphaera	225143	G	125	16	141	0.00001
Methylococcus	413	G	5977	456	6433	0.00031
Methylomonas	416	G	3641	126	3767	0.00018
Methylomagnum	1760987	G	1889	88	1977	0.00010
Methylocaldum	73778	G	1641	95	1736	0.00008
Methylogaea	1295378	G	1630	129	1759	0.00009
Methylomicrobium	39773	G	1432	231	1663	0.00008
Candidatus Methylospira	1808977	G	489	22	511	0.00002
Methylotuvimicrobium	2822410	G	361	157	518	0.00003
Methylovulum	762296	G	294	7	301	0.00001
Solimonas	413435	G	4860	507	5367	0.00026
Flagellatimonas	2893022	G	1643	109	1752	0.00009
Sinimarinibacterium	1861863	G	675	358	1033	0.00005
Steroidobacter	469322	G	6216	1587	7803	0.00038
Microbulbifer	48073	G	5649	333	5982	0.00029
Kineobactrum	2678529	G	982	36	1018	0.00005
Halioglobus	1217416	G	748	24	772	0.00004
Congregibacter	393661	G	433	160	593	0.00003
Aequoribacter	2847769	G	119	12	131	0.00001
Cellvibrio	10	G	1268	53	1321	0.00006
Simiduia	447467	G	367	18	385	0.00002
Teredinibacter	2425	G	327	14	341	0.00002
Spongiibacter	630749	G	825	68	893	0.00004
Zhongshania	1434050	G	141	8	149	0.00001
Shewanella	22	G	5218	913	6131	0.00030
Alteromonas	226	G	662	107	769	0.00004
Salinimonas	288793	G	317	54	371	0.00002
Hydrocarboniclastica	2650549	G	471	67	538	0.00003
Lacimicrobium	1751872	G	172	13	185	0.00001
Paraglaciecola	1621534	G	144	12	156	0.00001
Agarivorans	261825	G	132	12	144	0.00001
Saliniradius	2661818	G	130	13	143	0.00001
Pseudoalteromonas	53246	G	1518	221	1739	0.00008
Ferrimonas	44011	G	667	87	754	0.00004
Colwellia	28228	G	123	18	141	0.00001
Thalassotalea	1518149	G	123	17	140	0.00001
Idiomarina	135575	G	274	33	307	0.00001
Sulfurifustis	1692042	G	6236	403	6639	0.00032
Sulfuricaulis	1744881	G	2231	170	2401	0.00012
Acidiferrobacter	986106	G	1917	38	1955	0.00009
Vibrio	662	G	4792	1125	5917	0.00029
Photobacterium	657	G	822	169	991	0.00005
Salinivibrio	51366	G	161	21	182	0.00001
Grimontia	246861	G	101	15	116	0.00001
Acinetobacter	469	G	4174	2526	6700	0.00033
Psychrobacter	497	G	421	20	441	0.00002
Moraxella	475	G	296	28	324	0.00002
Immundisolibacter	1934947	G	2920	550	3470	0.00017
Candidatus Endoriftia	393764	G	784	39	823	0.00004
Sedimenticola	349742	G	522	22	544	0.00003
Candidatus Reidiella	2738850	G	427	9	436	0.00002
Thiolapillus	1608298	G	294	7	301	0.00001
Pseudohongiella	1524249	G	232	6	238	0.00001
Gallaecimonas	745410	G	149	12	161	0.00001
Thiomicrorhabdus	2039723	G	243	14	257	0.00001
Methylophaga	40222	G	175	49	224	0.00001
Thiomicrospira	933	G	165	45	210	0.00001
Hydrogenovibrio	28884	G	151	57	208	0.00001
Thiothrix	1030	G	849	29	878	0.00004
Francisella	262	G	170	30	200	0.00001
Salinisphaera	180541	G	1946	88	2034	0.00010
Legionella	445	G	1097	116	1213	0.00006
Aquicella	254245	G	308	10	318	0.00002
Coxiella	776	G	159	22	181	0.00001
Cardiobacterium	2717	G	1049	149	1198	0.00006
Haemophilus	724	G	206	76	282	0.00001
Aggregatibacter	416916	G	184	47	231	0.00001
Actinobacillus	713	G	153	85	238	0.00001
Mannheimia	75984	G	145	38	183	0.00001
Pasteurella	745	G	116	116	232	0.00001
Kangiella	261963	G	162	10	172	0.00001
Archangium	47	G	72221	7439	79660	0.00387
Cystobacter	42	G	14372	3091	17463	0.00085
Stigmatella	40	G	11492	1118	12610	0.00061
Melittangium	44	G	7728	1558	9286	0.00045
Myxococcus	32	G	33642	21620	55262	0.00268
Corallococcus	83461	G	30959	4286	35245	0.00171
Pyxidicoccus	224458	G	20500	1357	21857	0.00106
Anaeromyxobacter	161492	G	55108	4842	59950	0.00291
Vulgatibacter	1524214	G	5906	533	6439	0.00031
Sorangium	39643	G	80683	9914	90597	0.00440
Polyangium	55	G	23862	2237	26099	0.00127
Chondromyces	50	G	10155	466	10621	0.00052
Pajaroellobacter	1882917	G	126	4	130	0.00001
Sandaracinus	1055688	G	33594	1995	35589	0.00173
Labilithrix	1524217	G	12148	555	12703	0.00062
Haliangium	162027	G	15254	875	16129	0.00078
Geomonas	2651583	G	10936	1686	12622	0.00061
Geobacter	28231	G	9061	1086	10147	0.00049
Citrifermentans	2883512	G	3175	694	3869	0.00019
Geotalea	2910589	G	1368	88	1456	0.00007
Geoalkalibacter	392332	G	719	575	1294	0.00006
Trichlorobacter	115782	G	439	51	490	0.00002
Desulfuromonas	890	G	7624	921	8545	0.00041
Pelobacter	18	G	1076	354	1430	0.00007
Syntrophotalea	2812025	G	1305	149	1454	0.00007
Pseudodesulfovibrio	2035811	G	7425	1309	8734	0.00042
Desulfovibrio	872	G	7353	948	8301	0.00040
Solidesulfovibrio	2910984	G	5285	518	5803	0.00028
Oceanidesulfovibrio	2905722	G	1929	107	2036	0.00010
Desulfolutivibrio	2773294	G	1632	349	1981	0.00010
Desulfocurvibacter	2582840	G	1449	102	1551	0.00008
Megalodesulfovibrio	2910978	G	1282	55	1337	0.00006
Oleidesulfovibrio	2909705	G	328	401	729	0.00004
Paradesulfovibrio	2910986	G	167	15	182	0.00001
Maridesulfovibrio	2794998	G	133	12	145	0.00001
Desulfomicrobium	898	G	1486	157	1643	0.00008
Desulfohalobium	45662	G	339	15	354	0.00002
Desulfosarcina	2299	G	3182	432	3614	0.00018
Desulfococcus	896	G	776	123	899	0.00004
Desulfatibacillum	218207	G	560	15	575	0.00003
Desulfoluna	497721	G	530	23	553	0.00003
Desulfonema	45654	G	310	6	316	0.00002
Desulfobacter	2289	G	302	23	325	0.00002
Desulforapulum	2904687	G	208	17	225	0.00001
Desulfobulbus	893	G	1822	314	2136	0.00010
Desulfurivibrio	427922	G	720	35	755	0.00004
Desulfosudis	2904716	G	691	36	727	0.00004
Desulfosediminicola	2886823	G	303	30	333	0.00002
Persicimonas	2766927	G	5608	177	5785	0.00028
Bradymonas	1779136	G	1827	715	2542	0.00012
Desulfarculus	453229	G	2359	1257	3616	0.00018
Syntrophobacter	29526	G	1118	422	1540	0.00007
Desulfoglaeba	361106	G	909	48	957	0.00005
Desulfobacca	60892	G	398	10	408	0.00002
Desulfomonile	2357	G	383	3	386	0.00002
Syntrophus	43773	G	294	20	314	0.00002
Dissulfurimicrobium	1769732	G	138	9	147	0.00001
Candidatus Desulfofervidus	1902583	G	111	2	113	0.00001
Campylobacter	194	G	1081	203	1284	0.00006
Sulfurimonas	202746	G	716	50	766	0.00004
Helicobacter	209	G	557	59	616	0.00003
Nitratifractor	269260	G	275	18	293	0.00001
Sulfurovum	265570	G	233	18	251	0.00001
Hydrogenimonas	223785	G	316	28	344	0.00002
Sulfurospirillum	57665	G	171	8	179	0.00001
Acidithiobacillus	119977	G	2069	228	2297	0.00011
Bdellovibrio	958	G	971	41	1012	0.00005
Hydrogenophilus	70774	G	700	159	859	0.00004
Mariprofundus	377315	G	400	14	414	0.00002
Gemmata	113	G	44440	4042	48482	0.00235
Urbifossiella	2807415	G	40359	3706	44065	0.00214
Frigoriglobus	2774146	G	23842	3863	27705	0.00135
Limnoglobus	2731450	G	17948	863	18811	0.00091
Tuwongella	2051044	G	1769	76	1845	0.00009
Telmatocola	1382832	G	1364	14	1378	0.00007
Tautonia	2680020	G	24480	2261	26741	0.00130
Aquisphaera	1511635	G	20607	3610	24217	0.00118
Paludisphaera	1763521	G	12594	2791	15385	0.00075
Singulisphaera	466152	G	10031	1487	11518	0.00056
Isosphaera	127	G	2126	156	2282	0.00011
Lacipirellula	2691417	G	18033	1216	19249	0.00093
Pirellulimonas	2795783	G	6864	744	7608	0.00037
Botrimarina	2795782	G	6100	568	6668	0.00032
Aeoliella	2795781	G	2162	174	2336	0.00011
Adhaeretor	2862451	G	1295	122	1417	0.00007
Bythopirellula	1400386	G	1059	74	1133	0.00006
Stieleria	2795973	G	4421	478	4899	0.00024
Lignipirellula	2795775	G	4400	470	4870	0.00024
Anatilimnocola	2807414	G	4060	411	4471	0.00022
Rosistilla	2795779	G	3920	269	4189	0.00020
Bremerella	2714594	G	2810	201	3011	0.00015
Pirellula	123	G	2779	92	2871	0.00014
Roseimaritima	1579506	G	2414	151	2565	0.00012
Rubripirellula	1579505	G	1017	183	1200	0.00006
Rhodopirellula	265488	G	739	49	788	0.00004
Mariniblastus	2005380	G	723	13	736	0.00004
Aureliella	2795605	G	655	49	704	0.00003
Thermogutta	1676125	G	761	23	784	0.00004
Planctomyces	118	G	21543	5107	26650	0.00129
Caulifigura	2795778	G	8567	539	9106	0.00044
Gimesia	1649453	G	6006	296	6302	0.00031
Alienimonas	2714737	G	5931	428	6359	0.00031
Maioricimonas	2795777	G	5023	586	5609	0.00027
Symmachiella	2795780	G	2030	111	2141	0.00010
Fuerstiella	1936111	G	1246	20	1266	0.00006
Rubinisphaera	1649490	G	1102	103	1205	0.00006
Planctopirus	1649480	G	1009	38	1047	0.00005
Calycomorphotria	2795776	G	1000	35	1035	0.00005
Crateriforma	2714592	G	960	196	1156	0.00006
Thalassoglobus	2795865	G	409	20	429	0.00002
Polystyrenella	2795774	G	405	32	437	0.00002
Humisphaera	2807511	G	18867	540	19407	0.00094
Phycisphaera	666508	G	5128	464	5592	0.00027
Mucisphaera	2913022	G	2290	136	2426	0.00012
Poriferisphaera	2803301	G	254	1	255	0.00001
Anaerohalosphaera	2690159	G	420	14	434	0.00002
Limihaloglobus	2690160	G	162	8	170	0.00001
Sedimentisphaera	2483368	G	135	56	191	0.00001
Candidatus Kuenenia	380738	G	165	0	165	0.00001
Opitutus	178440	G	9641	781	10422	0.00051
Lacunisphaera	1961799	G	3765	495	4260	0.00021
Nibricoccus	2576890	G	2601	109	2710	0.00013
Oleiharenicola	2100741	G	2332	120	2452	0.00012
Ereboglobus	2028344	G	1584	74	1658	0.00008
Ruficoccus	2175957	G	943	160	1103	0.00005
Coraliomargarita	442430	G	258	6	264	0.00001
Verrucomicrobium	2735	G	4907	380	5287	0.00026
Luteolibacter	518753	G	3715	140	3855	0.00019
Roseimicrobium	1348508	G	2971	96	3067	0.00015
Sulfuriroseicoccus	2911469	G	532	50	582	0.00003
Akkermansia	239934	G	1574	115	1689	0.00008
Methylacidimicrobium	1541670	G	1490	114	1604	0.00008
Methylacidiphilum	511745	G	122	4	126	0.00001
Candidatus Xiphinematobacter	134550	G	100	6	106	0.00001
Kiritimatiella	1921784	G	1028	1149	2177	0.00011
Tichowtungia	2907187	G	353	12	365	0.00002
Candidatus Velamenicoccus	2789201	G	234	1	235	0.00001
Hymenobacter	89966	G	30847	1269	32116	0.00156
Pontibacter	323449	G	6279	519	6798	0.00033
Adhaeribacter	299566	G	3435	192	3627	0.00018
Rufibacter	1379908	G	2005	355	2360	0.00011
Nibribacter	1649474	G	604	207	811	0.00004
Spirosoma	107	G	5540	236	5776	0.00028
Rhodocytophaga	455076	G	3021	94	3115	0.00015
Aquirufa	2676247	G	165	19	184	0.00001
Cytophaga	978	G	141	10	151	0.00001
Dyadobacter	120831	G	2431	134	2565	0.00012
Fibrella	861914	G	1395	79	1474	0.00007
Runella	105	G	799	26	825	0.00004
Larkinella	332157	G	270	15	285	0.00001
Chryseolinea	1433993	G	1705	42	1747	0.00008
Fulvivirga	396811	G	525	23	548	0.00003
Echinicola	390846	G	605	80	685	0.00003
Algoriphagus	246875	G	309	27	336	0.00002
Cyclobacterium	68288	G	149	15	164	0.00001
Aquiflexum	280472	G	109	12	121	0.00001
Flammeovirga	59739	G	156	8	164	0.00001
Chitinophaga	79328	G	4722	328	5050	0.00025
Flavisolibacter	398041	G	3433	312	3745	0.00018
Niastella	354354	G	2485	288	2773	0.00013
Pseudocnuella	2812019	G	2123	284	2407	0.00012
Flavihumibacter	1004301	G	1548	96	1644	0.00008
Paraflavitalea	2698688	G	1475	124	1599	0.00008
Niabella	379899	G	1183	99	1282	0.00006
Pseudobacter	1860196	G	1156	110	1266	0.00006
Arachidicoccus	1769012	G	974	140	1114	0.00005
Ferruginibacter	1004303	G	805	53	858	0.00004
Panacibacter	1874621	G	772	40	812	0.00004
Lacibacter	649461	G	755	37	792	0.00004
Phnomibacter	2836216	G	602	78	680	0.00003
Filimonas	649460	G	563	75	638	0.00003
Flavobacterium	237	G	4411	580	4991	0.00024
Muricauda	111500	G	531	142	673	0.00003
Capnocytophaga	1016	G	491	66	557	0.00003
Gramella	292691	G	485	90	575	0.00003
Polaribacter	52959	G	413	69	482	0.00002
Robiginitalea	252306	G	325	20	345	0.00002
Nonlabens	363408	G	287	53	340	0.00002
Winogradskyella	286104	G	232	60	292	0.00001
Antarcticibacterium	2058174	G	205	35	240	0.00001
Maribacter	252356	G	192	55	247	0.00001
Aequorivita	153265	G	176	9	185	0.00001
Myroides	76831	G	165	73	238	0.00001
Tenacibaculum	104267	G	160	38	198	0.00001
Salegentibacter	143222	G	145	98	243	0.00001
Formosa	225842	G	142	30	172	0.00001
Cellulophaga	104264	G	141	24	165	0.00001
Sinomicrobium	1434045	G	140	6	146	0.00001
Aquimarina	290174	G	133	10	143	0.00001
Chryseobacterium	59732	G	2414	816	3230	0.00016
Kaistella	2782231	G	320	48	368	0.00002
Epilithonimonas	2782229	G	100	117	217	0.00001
Elizabethkingia	308865	G	271	82	353	0.00002
Blattabacterium	34098	G	221	26	247	0.00001
Alistipes	239759	G	6249	2081	8330	0.00040
Prevotella	838	G	2137	292	2429	0.00012
Bacteroides	816	G	1630	797	2427	0.00012
Phocaeicola	909656	G	288	146	434	0.00002
Tannerella	195950	G	567	35	602	0.00003
Parabacteroides	375288	G	504	305	809	0.00004
Sodaliphilus	2815786	G	392	193	585	0.00003
Duncaniella	2518495	G	256	19	275	0.00001
Muribaculum	1918540	G	234	15	249	0.00001
Porphyromonas	836	G	699	77	776	0.00004
Proteiniphilum	294702	G	134	8	142	0.00001
Petrimonas	307628	G	112	9	121	0.00001
Barnesiella	397864	G	219	280	499	0.00002
Butyricimonas	574697	G	104	43	147	0.00001
Draconibacterium	1471399	G	187	12	199	0.00001
Rhodocaloribacter	2893090	G	5196	552	5748	0.00028
Rhodothermus	29548	G	4406	270	4676	0.00023
Salinibacter	146918	G	3365	61	3426	0.00017
Mucilaginibacter	423349	G	3953	299	4252	0.00021
Pedobacter	84567	G	2149	162	2311	0.00011
Sphingobacterium	28453	G	1367	631	1998	0.00010
Anseongella	1773450	G	310	13	323	0.00002
Olivibacter	376469	G	239	22	261	0.00001
Solitalea	929509	G	227	18	245	0.00001
Haliscomenobacter	2349	G	373	6	379	0.00002
Chlorobaculum	256319	G	2060	149	2209	0.00011
Pelodictyon	1099	G	505	63	568	0.00003
Chlorobium	1091	G	350	35	385	0.00002
Prosthecochloris	1101	G	825	64	889	0.00004
Chloroherpeton	100715	G	182	3	185	0.00001
Candidatus Cyclonatronum	2489367	G	300	25	325	0.00002
Melioribacter	1134403	G	109	13	122	0.00001
Gemmatirosa	1706036	G	56295	5859	62154	0.00302
Gemmatimonas	173479	G	17527	520	18047	0.00088
Fibrobacter	832	G	145	3	148	0.00001
Luteitalea	2004797	G	68364	4455	72819	0.00354
Granulicella	940557	G	8720	822	9542	0.00046
Terriglobus	392733	G	5438	600	6038	0.00029
Acidobacterium	33973	G	3820	301	4121	0.00020
Candidatus Koribacter	658061	G	2935	97	3032	0.00015
Edaphobacter	388463	G	2310	253	2563	0.00012
Acidisarcina	2608728	G	1470	95	1565	0.00008
Paludibaculum	1649475	G	6738	215	6953	0.00034
Chloracidobacterium	458032	G	4434	228	4662	0.00023
Sulfidibacter	2915177	G	2605	58	2663	0.00013
Nitrospira	1234	G	9442	170	9612	0.00047
Leptospirillum	179	G	420	10	430	0.00002
Treponema	157	G	1276	184	1460	0.00007
Spirochaeta	146	G	1009	44	1053	0.00005
Salinispira	1616789	G	119	4	123	0.00001
Sphaerochaeta	399320	G	305	17	322	0.00002
Breznakiella	2845254	G	239	10	249	0.00001
Leptospira	171	G	479	7	486	0.00002
Turneriella	338321	G	362	3	365	0.00002
Pyramidobacter	638847	G	854	53	907	0.00004
Fretibacterium	1434006	G	725	12	737	0.00004
Aminomonas	81411	G	663	70	733	0.00004
Thermanaerovibrio	81461	G	637	132	769	0.00004
Cloacibacillus	508459	G	546	128	674	0.00003
Jonquetella	428711	G	352	62	414	0.00002
Candidatus Bipolaricaulis	2250122	G	832	42	874	0.00004
Candidatus Nanosynbacter	2093823	G	161	79	240	0.00001
Thermotoga	2335	G	371	29	400	0.00002
Pseudothermotoga	1643951	G	105	5	110	0.00001
Mesotoga	1184396	G	119	7	126	0.00001
Kosmotoga	651456	G	106	5	111	0.00001
Thermocrinis	75905	G	105	26	131	0.00001
Thermovibrio	171868	G	127	51	178	0.00001
Thermosulfurimonas	1522431	G	223	23	246	0.00001
Thermosulfuriphilus	2033601	G	100	4	104	0.00001
Desulfurispirillum	393029	G	345	205	550	0.00003
Fusobacterium	848	G	182	54	236	0.00001
Geovibrio	46200	G	129	28	157	0.00001
Caldithrix	187144	G	316	3	319	0.00002
Fusarium	5506	G	18522	1131	19653	0.00095
Trichoderma	5543	G	6115	217	6332	0.00031
Beauveria	5581	G	4097	126	4223	0.00021
Cordyceps	45234	G	1868	100	1968	0.00010
Metarhizium	5529	G	3616	394	4010	0.00019
Ustilaginoidea	124426	G	1145	47	1192	0.00006
Pochonia	243023	G	385	24	409	0.00002
Purpureocillium	1052105	G	2248	133	2381	0.00012
Drechmeria	98402	G	1608	64	1672	0.00008
Clonostachys	110564	G	817	48	865	0.00004
Colletotrichum	5455	G	2273	373	2646	0.00013
Thermothielavioides	2609811	G	2531	135	2666	0.00013
Thermothelomyces	1920207	G	1853	71	1924	0.00009
Neurospora	5140	G	865	36	901	0.00004
Pyricularia	48558	G	2791	19	2810	0.00014
Neopestalotiopsis	1562158	G	1384	16	1400	0.00007
Botrytis	33196	G	350	2	352	0.00002
Aspergillus	5052	G	1951	100	2051	0.00010
Penicillium	5073	G	1922	101	2023	0.00010
Paecilomyces	33202	G	568	21	589	0.00003
Talaromyces	5094	G	390	24	414	0.00002
Ampelomyces	50729	G	1433	159	1592	0.00008
Paraphaeosphaeria	125369	G	1228	456	1684	0.00008
Zymoseptoria	1047167	G	571	12	583	0.00003
Cercospora	29002	G	492	3	495	0.00002
Eremothecium	33170	G	390	284	674	0.00003
Lachancea	300275	G	158	9	167	0.00001
Kazachstania	71245	G	136	5	141	0.00001
Torulaspora	4948	G	130	9	139	0.00001
Tetrapisispora	113604	G	116	3	119	0.00001
Saccharomyces	4930	G	106	5	111	0.00001
Ogataea	461281	G	151	3	154	0.00001
Brettanomyces	13366	G	107	4	111	0.00001
Candida	1535326	G	187	4	191	0.00001
Yarrowia	4951	G	236	2	238	0.00001
Sugiyamaella	410829	G	137	10	147	0.00001
Pseudozyma	63298	G	3231	24	3255	0.00016
Ustilago	5269	G	643	12	655	0.00003
Sporisorium	63265	G	610	76	686	0.00003
Malassezia	55193	G	308	38	346	0.00002
Phlebiopsis	82309	G	1064	7	1071	0.00005
Rhizoctonia	1322061	G	230	8	238	0.00001
Marasmius	34448	G	166	5	171	0.00001
Cryptococcus	5206	G	338	51	389	0.00002
Phytophthora	4783	G	8003	1297	9300	0.00045
Pythium	4797	G	793	11	804	0.00004
