name	taxonomy_id	taxonomy_lvl	kraken_assigned_reads	added_reads	new_est_reads	fraction_total_reads
Bradyrhizobium sp. CCBAU 051011	858422	S	11447	7124	18571	0.00288
Bradyrhizobium sp. CCBAU 51753	1325100	S	3889	2847	6736	0.00104
Bradyrhizobium sp. BTAi1	288000	S	3070	1660	4730	0.00073
Bradyrhizobium sp. CCGE-LA001	1223566	S	2970	2769	5739	0.00089
Bradyrhizobium sp. ORS 278	114615	S	2912	2032	4944	0.00077
Bradyrhizobium sp. CCBAU 51765	1325102	S	2872	3052	5924	0.00092
Bradyrhizobium sp. 6(2017)	1197460	S	2825	2211	5036	0.00078
Bradyrhizobium sp. ORS 285	115808	S	2812	2007	4819	0.00075
Bradyrhizobium sp. SK17	2057741	S	2639	2689	5328	0.00083
Bradyrhizobium sp. CCBAU 53421	1325120	S	2463	2444	4907	0.00076
Bradyrhizobium sp. PSBB068	2715960	S	2286	2353	4639	0.00072
Bradyrhizobium sp. 1(2017)	1404888	S	1940	2022	3962	0.00061
Bradyrhizobium sp. CCBAU 53351	1325114	S	1809	3102	4911	0.00076
Bradyrhizobium sp. CCBAU 53340	1325112	S	1759	2462	4221	0.00065
Bradyrhizobium sp. CCBAU 53338	1325111	S	1711	2502	4213	0.00065
Bradyrhizobium sp.	376	S	1229	4862	6091	0.00094
Bradyrhizobium sp. WSM471	319017	S	561	2782	3343	0.00052
Bradyrhizobium sp. LCT2	2493093	S	287	1679	1966	0.00030
Bradyrhizobium sp. SG09	2599805	S	141	2341	2482	0.00038
Bradyrhizobium sp. TM102	2599819	S	139	2371	2510	0.00039
Bradyrhizobium icense	1274631	S	12525	5691	18216	0.00282
Bradyrhizobium erythrophlei	1437360	S	11526	3468	14994	0.00232
Bradyrhizobium paxllaeri	190148	S	11441	7650	19091	0.00296
Bradyrhizobium diazoefficiens	1355477	S	7919	23977	31896	0.00494
Bradyrhizobium lablabi	722472	S	4010	8835	12845	0.00199
Bradyrhizobium genosp. L	83637	S	3130	2058	5188	0.00080
Bradyrhizobium oligotrophicum	44255	S	3034	1558	4592	0.00071
Bradyrhizobium canariense	255045	S	3004	870	3874	0.00060
Bradyrhizobium japonicum	375	S	2407	7894	10301	0.00160
Bradyrhizobium zhanjiangense	1325107	S	2156	1722	3878	0.00060
Bradyrhizobium vignae	1549949	S	1958	1560	3518	0.00055
Bradyrhizobium symbiodeficiens	1404367	S	1958	2683	4641	0.00072
Bradyrhizobium cosmicum	1404864	S	1949	2295	4244	0.00066
Bradyrhizobium arachidis	858423	S	1921	1921	3842	0.00060
Bradyrhizobium guangdongense	1325090	S	1828	2542	4370	0.00068
Bradyrhizobium genosp. B	83627	S	1818	1404	3222	0.00050
Bradyrhizobium guangxiense	1325115	S	1664	2654	4318	0.00067
Bradyrhizobium guangzhouense	1325095	S	1641	2274	3915	0.00061
Bradyrhizobium amphicarpaeae	1404768	S	1262	1815	3077	0.00048
Bradyrhizobium betae	244734	S	1141	1674	2815	0.00044
Bradyrhizobium ottawaense	931866	S	475	6469	6944	0.00108
Bosea sp. Tri-49	1867715	S	4149	1960	6109	0.00095
Bosea sp. ANAM02	2020412	S	3371	2009	5380	0.00083
Bosea sp. F3-2	2599640	S	3221	1851	5072	0.00079
Bosea sp. RAC05	1842539	S	2802	1454	4256	0.00066
Bosea sp. AS-1	2015316	S	2517	1433	3950	0.00061
Bosea sp. PAMC 26642	1792307	S	2293	1098	3391	0.00053
Bosea vaviloviae	1526658	S	2546	1277	3823	0.00059
Rhodopseudomonas palustris	1076	S	18257	15038	33295	0.00516
Tardiphaga robiniae	943830	S	2191	908	3099	0.00048
Afipia sp. GAS231	1882747	S	2603	3579	6182	0.00096
Afipia carboxidovorans	40137	S	2216	627	2843	0.00044
Variibacter gotjawalensis	1333996	S	3845	860	4705	0.00073
Nitrobacter hamburgensis	912	S	2009	816	2825	0.00044
Nitrobacter winogradskyi	913	S	1429	695	2124	0.00033
Mesorhizobium sp. N3	675281	S	3747	1713	5460	0.00085
Mesorhizobium sp. 8	2584466	S	2782	1548	4330	0.00067
Mesorhizobium sp. DCY119	2108445	S	2066	1055	3121	0.00048
Mesorhizobium sp. Pch-S	2082387	S	1909	627	2536	0.00039
Mesorhizobium sp. M1E.F.Ca.ET.045.02.1.1	2493672	S	1613	1695	3308	0.00051
Mesorhizobium sp. M1B.F.Ca.ET.045.04.1.1	2493673	S	1607	1406	3013	0.00047
Mesorhizobium sp. M3A.F.Ca.ET.080.04.2.1	2493676	S	1546	1100	2646	0.00041
Mesorhizobium sp. M9A.F.Ca.ET.002.03.1.2	2493668	S	1542	1568	3110	0.00048
Mesorhizobium sp. J8	2777475	S	1541	1179	2720	0.00042
Mesorhizobium sp. M1A.F.Ca.IN.022.06.1.1	2493680	S	1513	1245	2758	0.00043
Mesorhizobium sp. M4B.F.Ca.ET.058.02.1.1	2493675	S	1454	1428	2882	0.00045
Mesorhizobium sp. 131-2-1	2744518	S	1453	1515	2968	0.00046
Mesorhizobium sp. L-2-11	2744521	S	1438	1192	2630	0.00041
Mesorhizobium sp. M1D.F.Ca.ET.043.01.1.1	2493669	S	1402	1625	3027	0.00047
Mesorhizobium sp. INR15	2654248	S	1391	575	1966	0.00030
Mesorhizobium sp. M6A.T.Cr.TU.016.01.1.1	2493677	S	1076	948	2024	0.00031
Mesorhizobium sp. M8A.F.Ca.ET.057.01.1.1	2493679	S	899	760	1659	0.00026
Mesorhizobium sp. M7D.F.Ca.US.005.01.1.1	2493678	S	836	736	1572	0.00024
Mesorhizobium sp. M2A.F.Ca.ET.043.05.1.1	2493671	S	831	1478	2309	0.00036
Mesorhizobium sp. NBSH29	2654249	S	804	179	983	0.00015
Mesorhizobium sp. NZP2077	2483404	S	783	652	1435	0.00022
Mesorhizobium sp. M7A.F.Ce.TU.012.03.2.1	2493681	S	773	804	1577	0.00024
Mesorhizobium sp. L-8-10	2744523	S	771	3567	4338	0.00067
Mesorhizobium sp. 113-3-3	2744516	S	718	825	1543	0.00024
Mesorhizobium sp. AA22	1854057	S	701	1104	1805	0.00028
Mesorhizobium sp. L-8-3	2744522	S	670	3195	3865	0.00060
Mesorhizobium sp. NZP2298	2483403	S	568	812	1380	0.00021
Mesorhizobium sp. 113-3-9	2744517	S	538	890	1428	0.00022
Mesorhizobium sp. M2A.F.Ca.ET.046.03.2.1	2493674	S	438	1870	2308	0.00036
Mesorhizobium sp. M2A.F.Ca.ET.043.02.1.1	2493670	S	397	1706	2103	0.00033
Mesorhizobium sp. 113-1-2	2744515	S	193	975	1168	0.00018
Mesorhizobium sp. WSM1497	278153	S	147	601	748	0.00012
Mesorhizobium sp. 131-3-5	2744520	S	107	601	708	0.00011
Mesorhizobium sp. 131-2-5	2744519	S	100	900	1000	0.00016
Mesorhizobium oceanicum	1670800	S	2876	1267	4143	0.00064
Mesorhizobium amorphae	71433	S	1432	814	2246	0.00035
Mesorhizobium loti	381	S	1215	11335	12550	0.00195
Mesorhizobium ciceri	39645	S	1072	6266	7338	0.00114
Mesorhizobium australicum	536018	S	1062	869	1931	0.00030
Mesorhizobium opportunistum	593909	S	1016	843	1859	0.00029
Mesorhizobium erdmanii	1777866	S	809	683	1492	0.00023
Mesorhizobium huakuii	28104	S	797	1150	1947	0.00030
Mesorhizobium japonicum	2066070	S	715	1489	2204	0.00034
Aminobacter sp. SR38	2774562	S	2408	9848	12256	0.00190
Aminobacter sp. MSH1	374606	S	2241	1619	3860	0.00060
Aminobacter sp. MDW-2	2666139	S	510	3360	3870	0.00060
Aminobacter aminovorans	83263	S	723	2679	3402	0.00053
Chelativorans sp. BNC1	266779	S	6197	1741	7938	0.00123
Nitratireductor sp. SY7	2599600	S	2386	1082	3468	0.00054
Nitratireductor sp. OM-1	1756988	S	1180	358	1538	0.00024
Roseitalea porphyridii	1852022	S	1781	791	2572	0.00040
Hoeflea sp. IMCC20628	1620421	S	837	207	1044	0.00016
Hoeflea phototrophica	244596	S	765	220	985	0.00015
Oricola thermophila	2742145	S	1370	460	1830	0.00028
Phyllobacterium zundukense	1867719	S	839	237	1076	0.00017
Phyllobacterium sp. 628	2718938	S	496	93	589	0.00009
Salaquimonas pukyongi	2712698	S	538	93	631	0.00010
Rhizobium sp. BG4	2613770	S	1080	412	1492	0.00023
Rhizobium sp. NXC24	2048897	S	806	293	1099	0.00017
Rhizobium sp. WL3	2603277	S	746	287	1033	0.00016
Rhizobium sp. 11515TR	2028343	S	731	289	1020	0.00016
Rhizobium sp. ACO-34A	1571470	S	716	296	1012	0.00016
Rhizobium sp. CIAT894	2020312	S	582	628	1210	0.00019
Rhizobium sp. NZLR1	2731096	S	547	511	1058	0.00016
Rhizobium sp. NXC14	1981173	S	517	634	1151	0.00018
Rhizobium sp. NLR16a	2731112	S	444	647	1091	0.00017
Rhizobium sp. ADMK78	1813451	S	417	116	533	0.00008
Rhizobium sp. Khangiran2	1435607	S	318	575	893	0.00014
Rhizobium sp. Kim5	2020311	S	299	1411	1710	0.00027
Rhizobium sp. IE4771	1301032	S	284	1086	1370	0.00021
Rhizobium sp. 007	2785056	S	259	429	688	0.00011
Rhizobium sp. TAL182	2020313	S	121	753	874	0.00014
Rhizobium sp. TCK	136098	S	107	481	588	0.00009
Rhizobium leguminosarum	384	S	5446	11988	17434	0.00270
Rhizobium etli	29449	S	2081	4525	6606	0.00102
Rhizobium favelukesii	348824	S	1151	363	1514	0.00023
Rhizobium phaseoli	396	S	1086	3385	4471	0.00069
Rhizobium jaguaris	1312183	S	1004	287	1291	0.00020
Rhizobium pseudoryzae	379684	S	921	347	1268	0.00020
Rhizobium bangladeshense	1138189	S	722	450	1172	0.00018
Rhizobium gallicum	56730	S	717	1305	2022	0.00031
Rhizobium lentis	1138194	S	676	497	1173	0.00018
Rhizobium lusitanum	293958	S	666	266	932	0.00014
Rhizobium binae	1138190	S	660	566	1226	0.00019
Rhizobium tropici	398	S	615	340	955	0.00015
Rhizobium rosettiformans	1368430	S	584	376	960	0.00015
Rhizobium rhizoryzae	451876	S	548	107	655	0.00010
Rhizobium daejeonense	240521	S	494	268	762	0.00012
Rhizobium indicum	2583231	S	401	633	1034	0.00016
Rhizobium flavum	1335061	S	368	463	831	0.00013
Rhizobium acidisoli	1538158	S	365	429	794	0.00012
Rhizobium oryzihabitans	2267833	S	333	325	658	0.00010
Rhizobium pusense	648995	S	242	1233	1475	0.00023
Rhizobium hidalgonense	1538159	S	108	330	438	0.00007
Rhizobium ruizarguesonis	2081791	S	101	608	709	0.00011
Agrobacterium tumefaciens	358	S	2497	3916	6413	0.00099
Agrobacterium fabrum	1176649	S	258	646	904	0.00014
Agrobacterium vitis	373	S	1138	299	1437	0.00022
Agrobacterium sp. T29	2580515	S	183	266	449	0.00007
Agrobacterium sp. MA01	2664893	S	159	437	596	0.00009
Agrobacterium sp. RAC06	1842536	S	147	435	582	0.00009
Agrobacterium rhizogenes	359	S	684	1243	1927	0.00030
Agrobacterium rubi	28099	S	416	144	560	0.00009
Agrobacterium larrymoorei	160699	S	383	99	482	0.00007
Neorhizobium galegae	399	S	2125	687	2812	0.00044
Neorhizobium sp. NCHU2750	1825976	S	879	329	1208	0.00019
Neorhizobium sp. SOG26	2060726	S	814	267	1081	0.00017
Pseudorhizobium banfieldiae	1125847	S	160	637	797	0.00012
Sinorhizobium fredii	380	S	6087	12760	18847	0.00292
Sinorhizobium meliloti	382	S	4028	2248	6276	0.00097
Sinorhizobium sp. RAC02	1842534	S	1331	598	1929	0.00030
Sinorhizobium sp. BG8	2613773	S	1208	353	1561	0.00024
Sinorhizobium sp. CCBAU 05631	794846	S	190	473	663	0.00010
Sinorhizobium americanum	194963	S	2681	2216	4897	0.00076
Sinorhizobium medicae	110321	S	1140	364	1504	0.00023
Ensifer adhaerens	106592	S	4501	3147	7648	0.00119
Ensifer mexicanus	375549	S	1655	527	2182	0.00034
Ensifer sp. PDNC004	2811423	S	1308	843	2151	0.00033
Ensifer alkalisoli	1752398	S	1141	538	1679	0.00026
Ensifer sojae	716925	S	1031	662	1693	0.00026
Shinella sp. HZN7	879274	S	2375	1850	4225	0.00066
Shinella sp. PSBB067	2715959	S	1698	1526	3224	0.00050
Kaistia sp. 32K	2795690	S	3237	1395	4632	0.00072
Georhizobium profundi	2341112	S	1366	491	1857	0.00029
Ciceribacter thiooxidans	1969821	S	1144	415	1559	0.00024
Methylobacterium sp. 4-46	426117	S	3668	1660	5328	0.00083
Methylobacterium sp. 17Sr1-43	2202828	S	2180	1092	3272	0.00051
Methylobacterium sp. WL1	2603276	S	1551	843	2394	0.00037
Methylobacterium sp. 17Sr1-1	2202826	S	1549	1787	3336	0.00052
Methylobacterium sp. AMS5	925818	S	742	970	1712	0.00027
Methylobacterium sp. DM1	2067957	S	463	1698	2161	0.00034
Methylobacterium sp. C1	1479019	S	297	2455	2752	0.00043
Methylobacterium sp. XJLW	739141	S	113	2083	2196	0.00034
Methylobacterium nodulans	114616	S	3457	1103	4560	0.00071
Methylobacterium aquaticum	270351	S	3235	3187	6422	0.00100
Methylobacterium durans	2202825	S	2511	864	3375	0.00052
Methylobacterium currus	2051553	S	1707	1736	3443	0.00053
Methylobacterium terrae	2202827	S	1626	1816	3442	0.00053
Methylobacterium mesophilicum	39956	S	1590	818	2408	0.00037
Methylobacterium brachiatum	269660	S	1443	1071	2514	0.00039
Methylobacterium indicum	1775910	S	1424	1674	3098	0.00048
Methylobacterium radiotolerans	31998	S	331	1530	1861	0.00029
Methylobacterium phyllosphaerae	418223	S	256	1681	1937	0.00030
Microvirga sp. VF16	2807101	S	5813	1744	7557	0.00117
Microvirga sp. 17 mud 1-3	2082949	S	2311	1028	3339	0.00052
Microvirga ossetica	1882682	S	6226	2030	8256	0.00128
Microvirga thermotolerans	2651334	S	3209	1823	5032	0.00078
Methylorubrum populi	223967	S	2839	2706	5545	0.00086
Methylorubrum extorquens	408	S	1870	6960	8830	0.00137
Rhodoplanes sp. Z2-YC6860	674703	S	22740	5426	28166	0.00437
Devosia sp. A16	1736675	S	3923	1185	5108	0.00079
Devosia sp. G19	2801335	S	1192	502	1694	0.00026
Devosia sp. S02	2657486	S	1156	461	1617	0.00025
Devosia sp. 1566	2499144	S	978	241	1219	0.00019
Devosia sp. I507	2083786	S	963	296	1259	0.00020
Devosia sp. LEGU1	2774137	S	928	276	1204	0.00019
Devosia sp. D6-9	2664417	S	506	1433	1939	0.00030
Devosia sp. MC521	2759954	S	426	77	503	0.00008
Devosia ginsengisoli	400770	S	1409	555	1964	0.00030
Hyphomicrobium denitrificans	53399	S	3266	763	4029	0.00062
Hyphomicrobium nitrativorans	1427356	S	3132	629	3761	0.00058
Hyphomicrobium sp. MC1	717785	S	1662	360	2022	0.00031
Blastochloris tepida	2233851	S	3009	1805	4814	0.00075
Blastochloris viridis	1079	S	2632	1548	4180	0.00065
Methyloceanibacter caenitepidi	1384459	S	1368	480	1848	0.00029
Methyloceanibacter sp. wino2	2170729	S	1320	500	1820	0.00028
Methyloligella sp. GL2	2742204	S	2012	523	2535	0.00039
Aquabacter sp. L1I39	2820278	S	2002	742	2744	0.00043
Rhodomicrobium vannielii	1069	S	1523	266	1789	0.00028
Youhaiella tibetensis	1447062	S	1386	511	1897	0.00029
Pelagibacterium halotolerans	531813	S	854	313	1167	0.00018
Candidatus Filomicrobium marinum	1608628	S	754	47	801	0.00012
Caenibius tardaugens	169176	S	551	386	937	0.00015
Paradevosia shaoguanensis	1335043	S	522	1534	2056	0.00032
Maritalea myrionectae	454601	S	178	10	188	0.00003
Pseudolabrys taiwanensis	331696	S	7823	2928	10751	0.00167
Pseudolabrys sp. FHR47	2562284	S	5897	2499	8396	0.00130
Starkeya sp. ORNL1	2709380	S	3731	1482	5213	0.00081
Starkeya novella	921	S	3675	105104	108779	0.01686
Ancylobacter sp. TS-1	1850374	S	2384	1436	3820	0.00059
Ancylobacter pratisalsi	1745854	S	1825	688	2513	0.00039
Xanthobacter sp. YN2	2528964	S	3436	1296	4732	0.00073
Azorhizobium caulinodans	7	S	2443	985	3428	0.00053
Labrys sp. KNU-23	2789216	S	2386	680	3066	0.00048
Nordella sp. HKS 07	2712222	S	7105	1391	8496	0.00132
Pseudorhodoplanes sinuspersici	1235591	S	6772	1486	8258	0.00128
Hartmannibacter diazotrophicus	1482074	S	2216	811	3027	0.00047
Methylocystis parvus	134	S	1471	382	1853	0.00029
Methylocystis rosea	173366	S	1463	708	2171	0.00034
Methylocystis bryophila	655015	S	1432	302	1734	0.00027
Methylocystis heyeri	391905	S	1304	294	1598	0.00025
Methylocystis sp. SC2	187303	S	820	630	1450	0.00022
Methylosinus trichosporium	426	S	1946	689	2635	0.00041
Methylosinus sp. C49	2699395	S	1555	534	2089	0.00032
Aureimonas sp. AU20	1349819	S	1831	660	2491	0.00039
Aureimonas sp. LMG 31693	2758041	S	1467	690	2157	0.00033
Aureimonas sp. OT7	2816454	S	1351	834	2185	0.00034
Aureimonas populi	1701758	S	1627	798	2425	0.00038
Martelella sp. AD-3	686597	S	499	1660	2159	0.00033
Martelella mediterranea	293089	S	951	612	1563	0.00024
Martelella endophytica	1486262	S	915	416	1331	0.00021
Martelella lutilitoris	2583532	S	503	660	1163	0.00018
Stappia indica	538381	S	2623	1305	3928	0.00061
Stappia sp. ES.058	1881061	S	1541	470	2011	0.00031
Labrenzia sp. VG12	2021862	S	900	463	1363	0.00021
Labrenzia sp. PHM005	2590016	S	380	94	474	0.00007
Labrenzia sp. THAF82	2587861	S	370	99	469	0.00007
Labrenzia alexandrii	388408	S	454	87	541	0.00008
Labrenzia aggregata	187304	S	112	811	923	0.00014
Pannonibacter phragmitetus	121719	S	1909	1579	3488	0.00054
Pseudovibrio sp. FO-BEG1	911045	S	257	18	275	0.00004
Chelatococcus sp. CO-6	1702325	S	2763	2793	5556	0.00086
Chelatococcus daeguensis	444444	S	1598	1741	3339	0.00052
Methylocella silvestris	199596	S	1382	361	1743	0.00027
Methylocella tundrae	227605	S	1235	265	1500	0.00023
Methylovirgula ligni	569860	S	1378	395	1773	0.00028
Beijerinckia indica	533	S	662	88	750	0.00012
Parvibaculum lavamentivorans	256618	S	1539	570	2109	0.00033
Pyruvatibacter mobilis	1712261	S	1060	279	1339	0.00021
Candidatus Phaeomarinobacter ectocarpi	1458461	S	494	59	553	0.00009
Brucella intermedia	94625	S	505	640	1145	0.00018
[Ochrobactrum] quorumnocens	271865	S	224	222	446	0.00007
Brucella anthropi	529	S	165	1003	1168	0.00018
Breoghania sp. L-A4	2304600	S	2218	755	2973	0.00046
Cohaesibacter sp. ES.047	1798205	S	416	43	459	0.00007
Lichenihabitans psoromatis	2528642	S	1355	273	1628	0.00025
Bartonella apis	1686310	S	118	38	156	0.00002
Sphingomonas sp. sand1-3	2764186	S	2401	860	3261	0.00051
Sphingomonas sp. HDW15C	2714944	S	2318	861	3179	0.00049
Sphingomonas sp. LMO-1	2681549	S	2161	842	3003	0.00047
Sphingomonas sp. HDW15A	2714942	S	2093	476	2569	0.00040
Sphingomonas sp. HDW15B	2714943	S	1941	475	2416	0.00037
Sphingomonas sp. CL5.1	2653203	S	1859	992	2851	0.00044
Sphingomonas sp. MM-1	745310	S	1660	2403	4063	0.00063
Sphingomonas sp. Cra20	1327635	S	1543	575	2118	0.00033
Sphingomonas sp. AP4-R1	2735134	S	1494	436	1930	0.00030
Sphingomonas sp. C33	2698679	S	1494	673	2167	0.00034
Sphingomonas sp. LM7	1938607	S	1436	702	2138	0.00033
Sphingomonas sp. C8-2	2492837	S	1412	2471	3883	0.00060
Sphingomonas sp. NBWT7	2596913	S	1409	769	2178	0.00034
Sphingomonas sp. MK52	2711156	S	1330	437	1767	0.00027
Sphingomonas sp. AAP5	1523415	S	1330	650	1980	0.00031
Sphingomonas sp. FARSPH	2219696	S	1236	1050	2286	0.00035
Sphingomonas sp. XS-10	2599297	S	1227	449	1676	0.00026
Sphingomonas sp. PAMC26645	2565555	S	984	605	1589	0.00025
Sphingomonas sp. KC8	1030157	S	941	414	1355	0.00021
Sphingomonas sp. DH-S5	2759526	S	935	282	1217	0.00019
Sphingomonas sp. HMP9	1517554	S	900	649	1549	0.00024
Sphingomonas sp. LK11	1390395	S	821	545	1366	0.00021
Sphingomonas sp. HMP6	1517551	S	808	326	1134	0.00018
Sphingomonas sp. NIC1	1961362	S	510	1601	2111	0.00033
Sphingomonas sp. YZ-8	2319844	S	439	44	483	0.00007
Sphingomonas sp. IC081	304378	S	349	1922	2271	0.00035
Sphingomonas sediminicola	386874	S	6649	1586	8235	0.00128
Sphingomonas daechungensis	1176646	S	3351	795	4146	0.00064
Sphingomonas lutea	1045317	S	3152	1039	4191	0.00065
Sphingomonas ginsengisoli An et al. 2013	363835	S	2893	1034	3927	0.00061
Sphingomonas rhizophila	2071607	S	2710	1027	3737	0.00058
Sphingomonas xanthus	2594473	S	2539	779	3318	0.00051
Sphingomonas wittichii	160791	S	2253	4315	6568	0.00102
Sphingomonas alpina	653931	S	2216	562	2778	0.00043
Sphingomonas sanxanigenens	397260	S	2110	1386	3496	0.00054
Sphingomonas koreensis	93064	S	1586	1429	3015	0.00047
Sphingomonas hengshuiensis	1609977	S	1453	496	1949	0.00030
Sphingomonas taxi	1549858	S	1423	871	2294	0.00036
Sphingomonas panacis	1560345	S	1385	449	1834	0.00028
Sphingomonas panacisoli	1813879	S	1197	428	1625	0.00025
Sphingomonas insulae	424800	S	1037	531	1568	0.00024
Sphingomonas paucimobilis	13689	S	1035	798	1833	0.00028
Sphingomonas melonis	152682	S	679	2490	3169	0.00049
Sphingomonas lacunae	2698828	S	575	120	695	0.00011
Sphingobium sp. Cam5-1	2789327	S	2856	1492	4348	0.00067
Sphingobium sp. SYK-6	627192	S	1355	641	1996	0.00031
Sphingobium sp. TKS	1315974	S	759	922	1681	0.00026
Sphingobium sp. CAP-1	2676077	S	740	783	1523	0.00024
Sphingobium sp. YG1	2082188	S	738	439	1177	0.00018
Sphingobium sp. RAC03	1843368	S	695	274	969	0.00015
Sphingobium sp. EP60837	1855519	S	695	272	967	0.00015
Sphingobium sp. SCG-1	2072936	S	666	113	779	0.00012
Sphingobium sp. KCTC 72723	2733867	S	646	198	844	0.00013
Sphingobium sp. MI1205	407020	S	501	791	1292	0.00020
Sphingobium sp. PAMC28499	2565554	S	194	745	939	0.00015
Sphingobium sp. YBL2	484429	S	101	763	864	0.00013
Sphingobium yanoikuyae	13690	S	1688	4027	5715	0.00089
Sphingobium amiense	135719	S	808	1325	2133	0.00033
Sphingobium cloacae	120107	S	756	1286	2042	0.00032
Sphingobium chlorophenolicum	46429	S	682	510	1192	0.00018
Sphingobium hydrophobicum	1673076	S	628	746	1374	0.00021
Sphingobium japonicum	332056	S	614	661	1275	0.00020
Sphingobium baderi	1332080	S	580	677	1257	0.00020
Sphingobium herbicidovorans	76947	S	522	419	941	0.00015
Sphingobium fuliginis	336203	S	120	668	788	0.00012
Sphingopyxis sp. QXT-31	1357916	S	1708	1001	2709	0.00042
Sphingopyxis sp. EG6	1874061	S	1490	1140	2630	0.00041
Sphingopyxis sp. OPL5	2486273	S	1261	576	1837	0.00028
Sphingopyxis sp. PAMC25046	2565556	S	1027	748	1775	0.00028
Sphingopyxis sp. 113P3	292913	S	965	517	1482	0.00023
Sphingopyxis sp. FD7	1914525	S	914	733	1647	0.00026
Sphingopyxis macrogoltabida	33050	S	2064	1387	3451	0.00053
Sphingopyxis terrae	33052	S	1206	820	2026	0.00031
Sphingopyxis lindanitolerans	2054227	S	1006	621	1627	0.00025
Sphingopyxis fribergensis	1515612	S	876	533	1409	0.00022
Sphingopyxis alaskensis	117207	S	766	496	1262	0.00020
Sphingopyxis granuli	267128	S	505	2894	3399	0.00053
Novosphingobium sp. Gsoil 351	2675225	S	2337	626	2963	0.00046
Novosphingobium sp. ABRDHK2	2571749	S	1841	1143	2984	0.00046
Novosphingobium sp. P6W	1609758	S	1538	356	1894	0.00029
Novosphingobium sp. THN1	1016987	S	1067	612	1679	0.00026
Novosphingobium sp. ES2-1	2780074	S	1015	665	1680	0.00026
Novosphingobium sp. PP1Y	702113	S	607	408	1015	0.00016
Novosphingobium sp. KA1	164608	S	438	2047	2485	0.00039
Novosphingobium resinovorum	158500	S	2304	1363	3667	0.00057
Novosphingobium aromaticivorans	48935	S	1448	7773	9221	0.00143
Novosphingobium ginsenosidimutans	1176536	S	1298	420	1718	0.00027
Novosphingobium pentaromativorans	205844	S	681	951	1632	0.00025
Sphingosinithalassobacter sp. CS137	2762748	S	1467	671	2138	0.00033
Sphingosinithalassobacter sp. zrk23	2711215	S	1122	582	1704	0.00026
Allosphingosinicella indica	941907	S	2353	925	3278	0.00051
Sphingorhabdus sp. SMR4y	2584094	S	484	113	597	0.00009
Sphingorhabdus sp. YGSMI21	2077182	S	425	95	520	0.00008
Sphingorhabdus sp. M41	1806885	S	381	78	459	0.00007
Sphingorhabdus sp. JK6	2725558	S	177	13	190	0.00003
Sphingorhabdus lacus	392610	S	307	32	339	0.00005
Parasphingopyxis algicola	2026624	S	1317	303	1620	0.00025
Parasphingopyxis sp. CP4	2724527	S	419	52	471	0.00007
Rhizorhabdus dicambivorans	1850238	S	1680	1891	3571	0.00055
Blastomonas sp. RAC04	1842535	S	362	706	1068	0.00017
Blastomonas fulva	1550728	S	239	641	880	0.00014
Tardibacter chloracetimidivorans	1921510	S	1040	905	1945	0.00030
Citromicrobium sp. JL477	1634516	S	1026	768	1794	0.00028
Novosphingopyxis sp. PB63	2762729	S	767	526	1293	0.00020
Parasphingorhabdus sp. JHSY0214	2806553	S	199	12	211	0.00003
Zymomonas mobilis	542	S	109	58	167	0.00003
Erythrobacter sp. HL-111	1798193	S	1293	904	2197	0.00034
Erythrobacter sp. HKB08	2502843	S	1065	665	1730	0.00027
Erythrobacter sp. 6D36	2782568	S	897	465	1362	0.00021
Erythrobacter sp. THAF29	2587851	S	639	279	918	0.00014
Erythrobacter sp. KY5	2011159	S	505	138	643	0.00010
Erythrobacter sp. A30-3	2785907	S	504	505	1009	0.00016
Erythrobacter litoralis	39960	S	1812	1685	3497	0.00054
Erythrobacter mangrovi	2739433	S	809	453	1262	0.00020
Erythrobacter neustonensis	1112	S	784	468	1252	0.00019
Erythrobacter aureus	2182384	S	713	266	979	0.00015
Porphyrobacter sp. CACIAM 03H1	2003315	S	1258	931	2189	0.00034
Porphyrobacter sp. YT40	2547601	S	938	1122	2060	0.00032
Porphyrobacter sp. HT-58-2	2023229	S	680	411	1091	0.00017
Porphyrobacter sp. LM 6	1896196	S	666	474	1140	0.00018
Altererythrobacter sp. B11	2060312	S	1657	1103	2760	0.00043
Altererythrobacter sp. TH136	2067415	S	1282	638	1920	0.00030
Altererythrobacter sp. BO-6	2604537	S	809	380	1189	0.00018
Altererythrobacter sp. ZODW24	2185142	S	348	58	406	0.00006
Altererythrobacter atlanticus	1267766	S	847	531	1378	0.00021
Altererythrobacter epoxidivorans	361183	S	593	337	930	0.00014
Altererythrobacter ishigakiensis	476157	S	245	46	291	0.00005
Tsuneonella dongtanensis	692370	S	1600	834	2434	0.00038
Tsuneonella amylolytica	2338327	S	1558	1057	2615	0.00041
Tsuneonella mangrovi	1982042	S	1216	563	1779	0.00028
Tsuneonella flava	2055955	S	428	282	710	0.00011
Croceicoccus marinus	450378	S	1601	1345	2946	0.00046
Croceicoccus sp. YJ47	2798724	S	882	614	1496	0.00023
Croceicoccus naphthovorans	1348774	S	757	1324	2081	0.00032
Qipengyuania flava	192812	S	1113	1149	2262	0.00035
Qipengyuania sediminis	1532023	S	1103	476	1579	0.00024
Qipengyuania seohaensis	266951	S	542	283	825	0.00013
Aurantiacibacter gangjinensis	502682	S	632	212	844	0.00013
Aurantiacibacter atlanticus	1648404	S	309	198	507	0.00008
Pelagerythrobacter marensis	543877	S	931	427	1358	0.00021
Paraurantiacibacter namhicola	645517	S	846	374	1220	0.00019
Sphingosinicella sp. BN140058	1892855	S	2964	740	3704	0.00057
Sphingosinicella sp. UDD2	2771430	S	1384	663	2047	0.00032
Sphingosinicella microcystinivorans	335406	S	1902	589	2491	0.00039
Sandaracinobacter sp. M6	2759707	S	1219	364	1583	0.00025
Azospirillum brasilense	192	S	3845	5069	8914	0.00138
Azospirillum sp. TSH100	652764	S	1154	941	2095	0.00032
Azospirillum sp. TSA2s	709810	S	1100	1289	2389	0.00037
Azospirillum sp. TSH58	664962	S	973	1712	2685	0.00042
Azospirillum thermophilum	2202148	S	3084	1466	4550	0.00071
Azospirillum lipoferum	193	S	2232	1906	4138	0.00064
Azospirillum thiophilum	528244	S	1774	1187	2961	0.00046
Azospirillum ramasamyi	682998	S	1014	980	1994	0.00031
Azospirillum oryzae	286727	S	842	1081	1923	0.00030
Azospirillum humicireducens	1226968	S	826	807	1633	0.00025
Azospirillum baldaniorum	1064539	S	623	1390	2013	0.00031
Skermanella sp. TT6	2775420	S	5236	4105	9341	0.00145
Skermanella pratensis	2233999	S	3846	2835	6681	0.00104
Hypericibacter adhaerens	2602016	S	4456	2024	6480	0.00100
Hypericibacter terrae	2602015	S	3655	1429	5084	0.00079
Magnetospirillum sp. XM-1	1663591	S	1170	777	1947	0.00030
Magnetospirillum sp. ME-1	1639348	S	856	600	1456	0.00023
Magnetospirillum gryphiswaldense	55518	S	1406	8477	9883	0.00153
Magnetospirillum magneticum	84159	S	1142	437	1579	0.00024
Rhodospirillum centenum	34018	S	2481	1126	3607	0.00056
Rhodospirillum rubrum	1085	S	1262	40	1302	0.00020
Ferrovibrio terrae	2594003	S	2473	613	3086	0.00048
Tistrella mobilis	171437	S	2368	685	3053	0.00047
Nitrospirillum amazonense	28077	S	2094	563	2657	0.00041
Indioceanicola profundi	2220096	S	1835	495	2330	0.00036
Defluviicoccus vanus	111831	S	1452	300	1752	0.00027
Thalassospira marina	2048283	S	251	29	280	0.00004
Thalassospira sp. A40-3	2785908	S	140	217	357	0.00006
Thalassospira indica	1891279	S	150	232	382	0.00006
Niveispirillum cyanobacteriorum	1612173	S	1022	240	1262	0.00020
Pararhodospirillum photometricum	1084	S	848	196	1044	0.00016
Magnetospira sp. QH-2	1288970	S	590	62	652	0.00010
Haematospirillum jordaniae	1549855	S	127	10	137	0.00002
Roseomonas sp. 546	2768162	S	2035	684	2719	0.00042
Roseomonas sp. 1318	2768161	S	1874	567	2441	0.00038
Roseomonas sp. FDAARGOS_362	2018065	S	203	1072	1275	0.00020
Roseomonas gilardii	257708	S	1340	967	2307	0.00036
Roseomonas mucosa	207340	S	217	1496	1713	0.00027
Stella humosa	94	S	5302	1609	6911	0.00107
Komagataeibacter xylinus	28448	S	670	1351	2021	0.00031
Komagataeibacter saccharivorans	265959	S	282	128	410	0.00006
Komagataeibacter hansenii	436	S	278	123	401	0.00006
Komagataeibacter nataicola	265960	S	203	155	358	0.00006
Komagataeibacter medellinensis	1177712	S	191	187	378	0.00006
Komagataeibacter oboediens	65958	S	177	78	255	0.00004
Komagataeibacter europaeus	33995	S	143	113	256	0.00004
Roseococcus sp. NIBR12	2771361	S	2301	618	2919	0.00045
Acidiphilium multivorum	62140	S	265	1184	1449	0.00022
Acidiphilium cryptum	524	S	164	744	908	0.00014
Lichenicola cladoniae	1484109	S	1481	205	1686	0.00026
Acidibrevibacterium fodinaquatile	1969806	S	1461	308	1769	0.00027
Acetobacter aceti	435	S	607	372	979	0.00015
Acetobacter persici	1076596	S	147	62	209	0.00003
Acetobacter sp. KACC 21233	2592655	S	118	62	180	0.00003
Gluconacetobacter diazotrophicus	33996	S	978	363	1341	0.00021
Gluconobacter oxydans	442	S	389	465	854	0.00013
Gluconobacter albidus	318683	S	158	40	198	0.00003
Gluconobacter sphaericus	574987	S	146	53	199	0.00003
Granulibacter bethesdensis	364410	S	644	106	750	0.00012
Neoasaia chiangmaiensis	320497	S	385	95	480	0.00007
Kozakia baliensis	153496	S	293	108	401	0.00006
Asaia bogorensis	91915	S	218	31	249	0.00004
Oecophyllibacter saccharovorans	2558360	S	211	38	249	0.00004
Swingsia sp. F3b2	2558361	S	115	8	123	0.00002
Parasaccharibacter apium	1510841	S	125	12	137	0.00002
Paracoccus sp. Arc7-R13	2500532	S	899	399	1298	0.00020
Paracoccus sp. MC1862	2760307	S	881	310	1191	0.00018
Paracoccus sp. AK26	2589076	S	795	285	1080	0.00017
Paracoccus sp. H4-D09	2812658	S	542	215	757	0.00012
Paracoccus sp. BM15	1529068	S	462	106	568	0.00009
Paracoccus sanguinis	1545044	S	1340	765	2105	0.00033
Paracoccus zhejiangensis	1077935	S	1143	511	1654	0.00026
Paracoccus yeei	147645	S	1096	1961	3057	0.00047
Paracoccus pantotrophus	82367	S	1088	910	1998	0.00031
Paracoccus liaowanqingii	2560053	S	992	290	1282	0.00020
Paracoccus aminovorans	34004	S	948	580	1528	0.00024
Paracoccus denitrificans	266	S	890	708	1598	0.00025
Paracoccus suum	2259340	S	815	328	1143	0.00018
Paracoccus jeotgali	2065379	S	725	298	1023	0.00016
Paracoccus contaminans	1945662	S	717	366	1083	0.00017
Paracoccus aminophilus	34003	S	678	152	830	0.00013
Paracoccus kondratievae	135740	S	421	156	577	0.00009
Rhodobacter sp. CZR27	2033869	S	1365	682	2047	0.00032
Rhodobacter sp. LPB0142	1850250	S	1126	755	1881	0.00029
Rhodobacter capsulatus	1061	S	1355	711	2066	0.00032
Rhodobacter blasticus	1075	S	929	328	1257	0.00019
Cereibacter sphaeroides	1063	S	4274	2389	6663	0.00103
Sulfitobacter sp. AM1-D1	1917485	S	712	651	1363	0.00021
Sulfitobacter sp. THAF37	2587855	S	543	419	962	0.00015
Sulfitobacter sp. D7	1968541	S	292	157	449	0.00007
Sulfitobacter sp. JL08	2070369	S	273	36	309	0.00005
Sulfitobacter sp. SK011	1389004	S	263	31	294	0.00005
Sulfitobacter sp. SK012	1389005	S	166	13	179	0.00003
Sulfitobacter sp. BSw21498	664426	S	151	87	238	0.00004
Sulfitobacter pseudonitzschiae	1402135	S	785	409	1194	0.00019
Sulfitobacter mediterraneus	83219	S	430	124	554	0.00009
Roseovarius sp. THAF9	2587847	S	470	279	749	0.00012
Roseovarius sp. THAF8	2587846	S	185	422	607	0.00009
Roseovarius sp. THAF27	2587850	S	185	481	666	0.00010
Roseovarius indicus	540747	S	1131	687	1818	0.00028
Roseovarius faecimaris	2494550	S	514	112	626	0.00010
Roseovarius mucosus	215743	S	107	408	515	0.00008
Salipiger profundus	1229727	S	1253	889	2142	0.00033
Salipiger pacificus	311180	S	1128	457	1585	0.00025
Yangia sp. CCB-MM3	1792508	S	975	336	1311	0.00020
Rhodovulum sp. P5	1564506	S	667	183	850	0.00013
Rhodovulum sp. MB263	308754	S	575	389	964	0.00015
Rhodovulum sulfidophilum	35806	S	979	831	1810	0.00028
Polymorphum gilvum	991904	S	2615	1471	4086	0.00063
Celeribacter indicus	1208324	S	1186	869	2055	0.00032
Celeribacter manganoxidans	1411902	S	610	235	845	0.00013
Celeribacter ethanolicus	1758178	S	448	220	668	0.00010
Celeribacter baekdonensis	875171	S	210	64	274	0.00004
Celeribacter marinus	1397108	S	125	12	137	0.00002
Paraoceanicella profunda	2579971	S	2031	919	2950	0.00046
Phaeobacter gallaeciensis	60890	S	546	414	960	0.00015
Phaeobacter inhibens	221822	S	402	266	668	0.00010
Phaeobacter piscinae	1580596	S	227	300	527	0.00008
Phaeobacter porticola	1844006	S	103	49	152	0.00002
Silicimonas algicola	1826607	S	1681	367	2048	0.00032
Leisingera aquaemixtae	1396826	S	536	239	775	0.00012
Leisingera sp. NJS201	2508306	S	134	284	418	0.00006
Leisingera sp. NJS204	2508307	S	133	292	425	0.00007
Leisingera methylohalidivorans	133924	S	389	160	549	0.00009
Pontivivens sp. MT2928	2789856	S	1419	354	1773	0.00027
Thioclava electrotropha	1549850	S	591	293	884	0.00014
Thioclava nitratireducens	1915078	S	585	344	929	0.00014
Roseivivax sp. THAF30	2587852	S	702	916	1618	0.00025
Ruegeria pomeroyi	89184	S	685	222	907	0.00014
Ruegeria sp. TM1040	292414	S	252	85	337	0.00005
Ruegeria sp. THAF33	2587853	S	198	102	300	0.00005
Ruegeria sp. AD91A	2293862	S	176	40	216	0.00003
Sagittula sp. P11	2009329	S	1227	895	2122	0.00033
Defluviimonas alba	1335048	S	1086	619	1705	0.00026
Pelagovum pacificum	2588711	S	1065	308	1373	0.00021
Tabrizicola piscis	2494374	S	1025	235	1260	0.00020
Pelagibaca abyssi	1250539	S	983	619	1602	0.00025
Marinovum algicola	42444	S	971	564	1535	0.00024
Brevirhabdus pacifica	1267768	S	878	619	1497	0.00023
Roseobacter ponti	1891787	S	350	48	398	0.00006
Roseobacter denitrificans	2434	S	250	68	318	0.00005
Roseobacter litoralis	42443	S	211	56	267	0.00004
Gemmobacter sp. HYN0069	2169400	S	818	218	1036	0.00016
Mameliella alba	561184	S	815	359	1174	0.00018
Dinoroseobacter shibae	215813	S	801	499	1300	0.00020
Haematobacter massiliensis	195105	S	767	400	1167	0.00018
Ketogulonicigenium vulgare	92945	S	382	183	565	0.00009
Ketogulonicigenium robustum	92947	S	326	79	405	0.00006
Roseibacterium elongatum	159346	S	688	205	893	0.00014
Octadecabacter sp. SW4	2602067	S	223	70	293	0.00005
Octadecabacter arcticus	53946	S	201	19	220	0.00003
Octadecabacter antarcticus	1217908	S	159	14	173	0.00003
Confluentimicrobium sp. EMB200-NS6	1609966	S	660	573	1233	0.00019
Oceanicola sp. D3	2587163	S	621	138	759	0.00012
Pseudopuniceibacterium antarcticum	2613965	S	572	146	718	0.00011
Pseudooceanicola algae	1537215	S	534	132	666	0.00010
Monaibacterium sp. ALG8	2715211	S	493	193	686	0.00011
Roseicitreum antarcticum	564137	S	482	94	576	0.00009
Thalassococcus sp. S3	2017482	S	470	66	536	0.00008
Jannaschia sp. CCS1	290400	S	470	59	529	0.00008
Maribius sp. THAF1	2587842	S	459	90	549	0.00009
Tateyamaria omphalii	299262	S	413	70	483	0.00007
Epibacterium mobile	379347	S	385	252	637	0.00010
Antarctobacter heliothermus	74033	S	372	69	441	0.00007
Qingshengfaniella alkalisoli	2599296	S	363	50	413	0.00006
Yoonia vestfoldensis	245188	S	343	137	480	0.00007
Thalassobius gelatinovorus	53501	S	291	50	341	0.00005
Rhodobaca barguzinensis	441209	S	288	33	321	0.00005
Boseongicola sp. CCM32	2552942	S	287	44	331	0.00005
Pseudohalocynthiibacter aestuariivivens	1591409	S	281	97	378	0.00006
Pseudorhodobacter turbinis	2500533	S	229	30	259	0.00004
Profundibacter amoris	2171755	S	227	35	262	0.00004
Cognatishimia activa	1715691	S	204	27	231	0.00004
Parasedimentitalea marina	2483033	S	189	20	209	0.00003
Marivivens sp. JLT3646	1920883	S	128	20	148	0.00002
Planktomarina temperata	1284658	S	119	7	126	0.00002
Halocynthiibacter arcticus	1579316	S	109	7	116	0.00002
Caulobacter sp. K31	366602	S	1423	743	2166	0.00034
Caulobacter sp. FWC26	69665	S	999	650	1649	0.00026
Caulobacter mirabilis	69666	S	2294	888	3182	0.00049
Caulobacter vibrioides	155892	S	1890	1289	3179	0.00049
Caulobacter flavus	1679497	S	1687	848	2535	0.00039
Caulobacter soli	2708539	S	1468	919	2387	0.00037
Caulobacter rhizosphaerae	2010972	S	1446	859	2305	0.00036
Caulobacter segnis	88688	S	1342	1456	2798	0.00043
Caulobacter henricii	69395	S	772	294	1066	0.00017
Brevundimonas sp. LVF2	2774190	S	970	354	1324	0.00021
Brevundimonas sp. M20	2591463	S	856	304	1160	0.00018
Brevundimonas sp. MF30-B	2561924	S	813	311	1124	0.00017
Brevundimonas sp. LM2	1938605	S	755	292	1047	0.00016
Brevundimonas sp. GRTSA-9	2800818	S	634	185	819	0.00013
Brevundimonas sp. LVF1	2774189	S	598	316	914	0.00014
Brevundimonas sp. AJA228-03	2752515	S	578	216	794	0.00012
Brevundimonas sp. SGAir0440	2579977	S	300	394	694	0.00011
Brevundimonas sp. CS1	2813778	S	266	383	649	0.00010
Brevundimonas sp. 'scallop'	2562582	S	189	467	656	0.00010
Brevundimonas sp. DS20	1532555	S	177	554	731	0.00011
Brevundimonas sp. GW460-12-10-14-LB2	1827469	S	173	366	539	0.00008
Brevundimonas sp. Bb-A	2560058	S	133	437	570	0.00009
Brevundimonas naejangsanensis	588932	S	1361	871	2232	0.00035
Brevundimonas subvibrioides	74313	S	823	363	1186	0.00018
Brevundimonas mediterranea	74329	S	647	406	1053	0.00016
Brevundimonas diminuta	293	S	370	916	1286	0.00020
Brevundimonas vesicularis	41276	S	202	469	671	0.00010
Brevundimonas vancanneytii	1325724	S	165	686	851	0.00013
Terricaulis silvestris	2686094	S	6275	715	6990	0.00108
Phenylobacterium zucineum	284016	S	4512	2044	6556	0.00102
Phenylobacterium parvum	2201350	S	1582	532	2114	0.00033
Asticcacaulis excentricus	78587	S	885	193	1078	0.00017
Phreatobacter stygius	1940610	S	3539	1243	4782	0.00074
Phreatobacter cathodiphilus	1868589	S	3235	1757	4992	0.00077
Phreatobacter sp. NMCR1094	2570229	S	2294	879	3173	0.00049
Micavibrio aeruginosavorus	349221	S	332	20	352	0.00005
Marinicauda algicola	2029849	S	1794	611	2405	0.00037
Maricaulis maris	74318	S	593	97	690	0.00011
Glycocaulis alkaliphilus	1434191	S	551	99	650	0.00010
Hyphobacterium sp. CCMP332	2749086	S	507	41	548	0.00008
Hyphomonas sp. CACIAM 19H1	1873716	S	662	100	762	0.00012
Hyphomonas sp. Mor2	1906738	S	426	33	459	0.00007
Hyphomonas sp. KY3	2016196	S	346	61	407	0.00006
Paremcibacter congregatus	2043170	S	236	14	250	0.00004
Luteithermobacter gelatinilyticus	2582913	S	232	22	254	0.00004
Parvularcula bermudensis	208216	S	300	46	346	0.00005
Variovorax sp. HW608	1034889	S	4323	1937	6260	0.00097
Variovorax sp. RA8	662548	S	2506	2628	5134	0.00080
Variovorax sp. PBS-H4	434008	S	2495	2010	4505	0.00070
Variovorax sp. WDL1	207745	S	2395	3031	5426	0.00084
Variovorax sp. PBL-H6	434009	S	2226	3436	5662	0.00088
Variovorax sp. PAMC 28711	1795631	S	1792	917	2709	0.00042
Variovorax sp. RKNM96	2681552	S	1453	1455	2908	0.00045
Variovorax sp. PAMC28562	2762323	S	1305	420	1725	0.00027
Variovorax sp. PAMC26660	2762322	S	1290	903	2193	0.00034
Variovorax sp. SRS16	282217	S	1057	3359	4416	0.00068
Variovorax sp. PBL-E5	434014	S	863	3673	4536	0.00070
Variovorax sp. 38R	2774875	S	860	1674	2534	0.00039
Variovorax paradoxus	34073	S	13002	15220	28222	0.00438
Variovorax boronicumulans	436515	S	1123	1767	2890	0.00045
Hydrogenophaga sp. PBC	795665	S	2738	2413	5151	0.00080
Hydrogenophaga sp. BA0156	2716225	S	2479	2224	4703	0.00073
Hydrogenophaga sp. YM1	2806262	S	2140	1883	4023	0.00062
Hydrogenophaga sp. BPS33	2651974	S	2019	1240	3259	0.00051
Hydrogenophaga sp. RAC07	1842537	S	1395	945	2340	0.00036
Hydrogenophaga sp. PBL-H3	434010	S	1299	1138	2437	0.00038
Hydrogenophaga sp. NH-16	2184519	S	951	2476	3427	0.00053
Hydrogenophaga sp. PAMC20947	2565558	S	694	142	836	0.00013
Hydrogenophaga pseudoflava	47421	S	1047	2266	3313	0.00051
Hydrogenophaga crassostreae	1763535	S	578	117	695	0.00011
Acidovorax sp. JMULE5	2518343	S	1107	642	1749	0.00027
Acidovorax sp. RAC01	1842533	S	845	610	1455	0.00023
Acidovorax sp. HDW3	2714923	S	810	558	1368	0.00021
Acidovorax sp. KKS102	358220	S	774	584	1358	0.00021
Acidovorax sp. 1608163	2478662	S	611	295	906	0.00014
Acidovorax sp. T1	1858609	S	495	952	1447	0.00022
Acidovorax sp. JS42	232721	S	137	2859	2996	0.00046
Acidovorax avenae	80867	S	2595	2961	5556	0.00086
Acidovorax monticola	1926868	S	1473	1254	2727	0.00042
Acidovorax antarcticus	2743470	S	1395	846	2241	0.00035
Acidovorax carolinensis	553814	S	1003	953	1956	0.00030
Acidovorax citrulli	80869	S	693	3214	3907	0.00061
Acidovorax cattleyae	80868	S	613	743	1356	0.00021
Ramlibacter tataouinensis	94132	S	10443	8858	19301	0.00299
Rhodoferax sp. BAB1	2741720	S	1708	1031	2739	0.00042
Rhodoferax sp. AJA081-3	2752316	S	523	122	645	0.00010
Rhodoferax sp. PAMC29310	2822760	S	363	65	428	0.00007
Rhodoferax koreense	1842727	S	2285	1764	4049	0.00063
Rhodoferax sediminis	2509614	S	2190	674	2864	0.00044
Rhodoferax ferrireducens	192843	S	711	142	853	0.00013
Rhodoferax saidenbachensis	1484693	S	541	180	721	0.00011
Rhodoferax antarcticus	81479	S	430	81	511	0.00008
Comamonas sp. NLF-7-7	2597701	S	1369	950	2319	0.00036
Comamonas serinivorans	1082851	S	1291	534	1825	0.00028
Comamonas testosteroni	285	S	1147	1258	2405	0.00037
Comamonas aquatica	225991	S	835	560	1395	0.00022
Comamonas koreensis	160825	S	685	338	1023	0.00016
Comamonas piscis	1562974	S	485	191	676	0.00010
Comamonas thiooxydans	363952	S	381	470	851	0.00013
Comamonas kerstersii	225992	S	330	130	460	0.00007
Polaromonas sp. JS666	296591	S	1661	1861	3522	0.00055
Polaromonas naphthalenivorans	216465	S	1300	464	1764	0.00027
Polaromonas vacuolata	37448	S	152	23	175	0.00003
Schlegelella thermodepolymerans	215580	S	4616	3511	8127	0.00126
Diaphorobacter sp. HDW4A	2714924	S	916	549	1465	0.00023
Diaphorobacter sp. HDW4B	2714925	S	784	278	1062	0.00016
Diaphorobacter sp. JS3051	2792224	S	112	2342	2454	0.00038
Diaphorobacter ruginosibacter	1715720	S	1079	506	1585	0.00025
Diaphorobacter aerolatus	1288495	S	838	611	1449	0.00022
Diaphorobacter polyhydroxybutyrativorans	1546149	S	105	1042	1147	0.00018
Kinneretia sp. DAIF2	2714952	S	4098	2252	6350	0.00098
Delftia acidovorans	80866	S	890	2991	3881	0.00060
Delftia sp. Cs1-4	742013	S	112	579	691	0.00011
Delftia lacustris	558537	S	161	1215	1376	0.00021
Delftia tsuruhatensis	180282	S	152	868	1020	0.00016
Ottowia sp. 27C	2816950	S	1485	669	2154	0.00033
Ottowia sp. oral taxon 894	1658672	S	621	186	807	0.00013
Ottowia oryzae	2109914	S	1100	562	1662	0.00026
Alicycliphilus denitrificans	179636	S	2728	4576	7304	0.00113
Serpentinomonas mccroryi	1458426	S	961	527	1488	0.00023
Serpentinomonas raichei	1458425	S	778	414	1192	0.00018
Hylemonella gracilis	80880	S	1319	525	1844	0.00029
Verminephrobacter eiseniae	364317	S	1305	486	1791	0.00028
Melaminivora sp. SC2-9	2109913	S	1294	1278	2572	0.00040
Pulveribacter suum	2116657	S	1093	1081	2174	0.00034
Simplicispira suum	2109915	S	790	365	1155	0.00018
Limnohabitans sp. 63ED37-2	1678128	S	490	135	625	0.00010
Limnohabitans sp. 103DPR2	1678129	S	184	23	207	0.00003
Curvibacter sp. AEP1-3	1844971	S	428	92	520	0.00008
Candidatus Symbiobacter mobilis	1436290	S	414	38	452	0.00007
Burkholderia multivorans	87883	S	2430	5174	7604	0.00118
Burkholderia cenocepacia	95486	S	1922	5682	7604	0.00118
Burkholderia cepacia	292	S	1786	13207	14993	0.00232
Burkholderia ubonensis	101571	S	1220	2816	4036	0.00063
Burkholderia lata	482957	S	1052	977	2029	0.00031
Burkholderia contaminans	488447	S	999	980	1979	0.00031
Burkholderia anthina	179879	S	930	1177	2107	0.00033
Burkholderia stagnalis	1503054	S	878	636	1514	0.00023
Burkholderia stabilis	95485	S	699	677	1376	0.00021
Burkholderia pyrrocinia	60550	S	657	651	1308	0.00020
Burkholderia territorii	1503055	S	577	561	1138	0.00018
Burkholderia ambifaria	152480	S	537	5442	5979	0.00093
Burkholderia seminalis	488731	S	497	458	955	0.00015
Burkholderia vietnamiensis	60552	S	402	1546	1948	0.00030
Burkholderia metallica	488729	S	373	350	723	0.00011
Burkholderia diffusa	488732	S	267	270	537	0.00008
Burkholderia pseudomultivorans	1207504	S	216	437	653	0.00010
Burkholderia latens	488446	S	147	524	671	0.00010
Burkholderia sp. DHOD12	2571746	S	1507	353	1860	0.00029
Burkholderia sp. THE68	758782	S	1210	407	1617	0.00025
Burkholderia sp. Bp7605	1740163	S	783	214	997	0.00015
Burkholderia sp. CCGE1003	640512	S	678	235	913	0.00014
Burkholderia sp. KK1	1855726	S	387	805	1192	0.00018
Burkholderia sp. JP2-270	2217913	S	377	373	750	0.00012
Burkholderia sp. NRF60-BP8	1637853	S	306	339	645	0.00010
Burkholderia sp. RPE67	758796	S	304	798	1102	0.00017
Burkholderia sp. LA-2-3-30-S1-D2	1637862	S	299	314	613	0.00010
Burkholderia sp. MS389	2811789	S	287	326	613	0.00010
Burkholderia sp. MSMB0856	1637869	S	257	282	539	0.00008
Burkholderia sp. YI23	1097668	S	248	621	869	0.00013
Burkholderia sp. PAMC 26561	1795043	S	237	225	462	0.00007
Burkholderia sp. MS455	2811788	S	232	252	484	0.00008
Burkholderia sp. PAMC 28687	1795874	S	169	345	514	0.00008
Burkholderia sp. IDO3	1705310	S	149	326	475	0.00007
Burkholderia pseudomallei	28450	S	1102	40562	41664	0.00646
Burkholderia thailandensis	57975	S	839	948	1787	0.00028
Burkholderia oklahomensis	342113	S	597	4128	4725	0.00073
Burkholderia sp. BDU8	1385592	S	353	214	567	0.00009
Burkholderia sp. BDU6	1385591	S	319	204	523	0.00008
Burkholderia gladioli	28095	S	3227	2195	5422	0.00084
Burkholderia plantarii	41899	S	1426	666	2092	0.00032
Burkholderia glumae	337	S	1347	822	2169	0.00034
Cupriavidus taiwanensis	164546	S	5543	7022	12565	0.00195
Cupriavidus pauculus	82633	S	3522	1584	5106	0.00079
Cupriavidus necator	106590	S	3425	2365	5790	0.00090
Cupriavidus oxalaticus	96344	S	2554	1783	4337	0.00067
Cupriavidus basilensis	68895	S	2372	1062	3434	0.00053
Cupriavidus campinensis	151783	S	1481	751	2232	0.00035
Cupriavidus metallidurans	119219	S	1374	695	2069	0.00032
Cupriavidus pinatubonensis	248026	S	1129	707	1836	0.00028
Cupriavidus gilardii	82541	S	502	3153	3655	0.00057
Cupriavidus sp. USMAA2-4	876364	S	131	743	874	0.00014
Cupriavidus sp. ISTL7	2771360	S	123	1240	1363	0.00021
Cupriavidus sp. USMAHM13	1389192	S	112	861	973	0.00015
Cupriavidus neocaledonicus	1040979	S	453	915	1368	0.00021
Cupriavidus nantongensis	1796606	S	349	770	1119	0.00017
Cupriavidus malaysiensis	367825	S	100	683	783	0.00012
Paraburkholderia sp. 7MH5	2547399	S	1727	513	2240	0.00035
Paraburkholderia sp. SOS3	1926494	S	1322	301	1623	0.00025
Paraburkholderia sp. PGU16	2735433	S	582	417	999	0.00015
Paraburkholderia sp. PGU19	2735434	S	571	457	1028	0.00016
Paraburkholderia sp. Msb3	2604047	S	397	345	742	0.00012
Paraburkholderia aromaticivorans	2026199	S	1450	765	2215	0.00034
Paraburkholderia caribensis	75105	S	1371	1414	2785	0.00043
Paraburkholderia acidisoli	2571748	S	1337	443	1780	0.00028
Paraburkholderia tropica	92647	S	1254	457	1711	0.00027
Paraburkholderia acidiphila	2571747	S	1090	373	1463	0.00023
Paraburkholderia phytofirmans	261302	S	982	546	1528	0.00024
Paraburkholderia atlantica	2654982	S	971	406	1377	0.00021
Paraburkholderia phymatum	148447	S	931	330	1261	0.00020
Paraburkholderia fungorum	134537	S	859	321	1180	0.00018
Paraburkholderia sprentiae	948107	S	853	361	1214	0.00019
Paraburkholderia megapolitana	420953	S	852	177	1029	0.00016
Paraburkholderia phenoliruptrix	252970	S	813	384	1197	0.00019
Paraburkholderia terricola	169427	S	758	369	1127	0.00017
Paraburkholderia graminis	60548	S	742	311	1053	0.00016
Paraburkholderia caledonica	134536	S	721	232	953	0.00015
Paraburkholderia ginsengisoli	311231	S	687	336	1023	0.00016
Paraburkholderia dokdonella	2211211	S	685	320	1005	0.00016
Paraburkholderia hospita	169430	S	652	721	1373	0.00021
Paraburkholderia caffeinilytica	1761016	S	643	284	927	0.00014
Paraburkholderia xenovorans	36873	S	624	557	1181	0.00018
Paraburkholderia acidophila	265293	S	548	697	1245	0.00019
Paraburkholderia terrae	311230	S	429	603	1032	0.00016
Ralstonia solanacearum	305	S	2825	8900	11725	0.00182
Ralstonia pickettii	329	S	1289	1628	2917	0.00045
Ralstonia insidiosa	190721	S	890	355	1245	0.00019
Ralstonia mannitolilytica	105219	S	636	794	1430	0.00022
Pandoraea pnomenusa	93220	S	1255	739	1994	0.00031
Pandoraea pulmonicola	93221	S	973	386	1359	0.00021
Pandoraea thiooxydans	445709	S	973	209	1182	0.00018
Pandoraea sp. XY-2	2518599	S	797	344	1141	0.00018
Pandoraea vervacti	656178	S	743	332	1075	0.00017
Pandoraea norimbergensis	93219	S	656	203	859	0.00013
Pandoraea faecigallinarum	656179	S	643	278	921	0.00014
Pandoraea apista	93218	S	618	298	916	0.00014
Pandoraea fibrosis	1891094	S	545	272	817	0.00013
Pandoraea oxalativorans	573737	S	491	297	788	0.00012
Pandoraea sputorum	93222	S	444	296	740	0.00011
Caballeronia sp. M1242	2814653	S	1028	1094	2122	0.00033
Caballeronia insecticola	758793	S	1030	302	1332	0.00021
Lautropia mirabilis	47671	S	987	275	1262	0.00020
Chitinimonas arctica	2594795	S	656	99	755	0.00012
Mycetohabitans rhizoxinica	412963	S	648	83	731	0.00011
Polynucleobacter necessarius	576610	S	144	40	184	0.00003
Limnobacter sp. SAORIC-580	2732163	S	145	9	154	0.00002
Rhizobacter sp. AJA081-3	2753607	S	10133	6300	16433	0.00255
Rhizobacter gummiphilus	946333	S	4787	2343	7130	0.00111
Methylibium petroleiphilum	105560	S	2076	2626	4702	0.00073
Methylibium sp. Pch-M	2082386	S	1929	3603	5532	0.00086
Rubrivivax gelatinosus	28068	S	6175	4113	10288	0.00159
Leptothrix cholodnii	34029	S	4320	2986	7306	0.00113
Thiomonas sp. X19	1050370	S	1351	585	1936	0.00030
Thiomonas intermedia	926	S	960	883	1843	0.00029
Thiomonas arsenitoxydans	426114	S	172	487	659	0.00010
Sphaerotilus natans	34103	S	3195	2334	5529	0.00086
Mitsuaria sp. 7	1658665	S	3017	1419	4436	0.00069
Xylophilus rhododendri	2697032	S	1833	1068	2901	0.00045
Aquabacterium olei	1296669	S	1582	774	2356	0.00037
Roseateles depolymerans	76731	S	1432	596	2028	0.00031
Inhella inkyongensis	392593	S	1167	380	1547	0.00024
Paucibacter sp. KCTC 42545	1768242	S	913	330	1243	0.00019
Bordetella sp. N	1746199	S	1193	309	1502	0.00023
Bordetella sp. H567	1697043	S	1154	358	1512	0.00023
Bordetella flabilis	463014	S	1483	351	1834	0.00028
Bordetella bronchialis	463025	S	1453	494	1947	0.00030
Bordetella genomosp. 13	463040	S	1443	741	2184	0.00034
Bordetella genomosp. 8	1416806	S	1341	419	1760	0.00027
Bordetella genomosp. 9	1416803	S	1233	414	1647	0.00026
Bordetella hinzii	103855	S	1093	723	1816	0.00028
Bordetella petrii	94624	S	1078	694	1772	0.00027
Bordetella trematum	123899	S	776	297	1073	0.00017
Bordetella pseudohinzii	1331258	S	627	439	1066	0.00017
Bordetella bronchiseptica	518	S	529	4934	5463	0.00085
Bordetella holmesii	35814	S	378	194	572	0.00009
Bordetella avium	521	S	326	77	403	0.00006
Bordetella genomosp. 6	463024	S	164	732	896	0.00014
Achromobacter xylosoxidans	85698	S	4261	6965	11226	0.00174
Achromobacter sp. AONIH1	1758194	S	1217	912	2129	0.00033
Achromobacter sp. MFA1 R4	1881016	S	1046	652	1698	0.00026
Achromobacter sp. B7	2282475	S	647	321	968	0.00015
Achromobacter spanius	217203	S	2184	1093	3277	0.00051
Achromobacter denitrificans	32002	S	1754	1633	3387	0.00053
Achromobacter insolitus	217204	S	979	552	1531	0.00024
Achromobacter pestifer	1353889	S	681	727	1408	0.00022
Achromobacter deleyi	1353891	S	399	981	1380	0.00021
Pigmentiphaga sp. H8	2488560	S	2563	786	3349	0.00052
Pigmentiphaga aceris	1940612	S	745	134	879	0.00014
Castellaniella defragrans	75697	S	1411	673	2084	0.00032
Orrella dioscoreae	1851544	S	1271	536	1807	0.00028
Pusillimonas thiosulfatoxidans	2028345	S	483	83	566	0.00009
Pusillimonas sp. T7-7	1007105	S	254	32	286	0.00004
Pusillimonas sp. DMV24BSW_D	2716226	S	137	11	148	0.00002
Alcaligenes faecalis	511	S	548	250	798	0.00012
Kerstersia gyiorum	206506	S	439	103	542	0.00008
Advenella kashmirensis	310575	S	181	13	194	0.00003
Advenella mimigardefordensis	302406	S	171	12	183	0.00003
Algicoccus marinus	2163011	S	188	15	203	0.00003
Massilia sp. WG5	1707785	S	1744	1472	3216	0.00050
Massilia sp. LPB0304	2769491	S	1309	1335	2644	0.00041
Massilia sp. NR 4-1	1678028	S	1094	565	1659	0.00026
Massilia sp. YMA4	1593482	S	1080	1120	2200	0.00034
Massilia sp. CCM 8941	2765360	S	961	662	1623	0.00025
Massilia putida	1141883	S	2196	1032	3228	0.00050
Massilia flava	871742	S	1877	954	2831	0.00044
Massilia oculi	945844	S	1438	676	2114	0.00033
Massilia umbonata	864828	S	1409	988	2397	0.00037
Massilia lutea	321985	S	1252	712	1964	0.00030
Massilia albidiflava	321983	S	1247	883	2130	0.00033
Massilia armeniaca	2072590	S	1143	1057	2200	0.00034
Massilia plicata	321984	S	1134	590	1724	0.00027
Massilia violaceinigra	2045208	S	1080	627	1707	0.00026
Herbaspirillum robiniae	2014887	S	1262	832	2094	0.00032
Herbaspirillum seropedicae	964	S	959	594	1553	0.00024
Herbaspirillum hiltneri	341045	S	918	400	1318	0.00020
Herbaspirillum rubrisubalbicans	80842	S	886	756	1642	0.00025
Herbaspirillum huttiense	863372	S	612	377	989	0.00015
Herbaspirillum frisingense	92645	S	592	341	933	0.00014
Herbaspirillum sp. meg3	2025949	S	458	119	577	0.00009
Janthinobacterium sp. 17J80-10	2497863	S	801	243	1044	0.00016
Janthinobacterium sp. 1_2014MBL_MicDiv	1644131	S	635	401	1036	0.00016
Janthinobacterium sp. LM6	1938606	S	313	286	599	0.00009
Janthinobacterium sp. Marseille	375286	S	214	57	271	0.00004
Janthinobacterium sp. HH102	1537274	S	143	260	403	0.00006
Janthinobacterium agaricidamnosum	55508	S	950	2424	3374	0.00052
Janthinobacterium tructae	2590869	S	270	230	500	0.00008
Janthinobacterium svalbardensis	368607	S	251	209	460	0.00007
Janthinobacterium lividum	29581	S	218	341	559	0.00009
Duganella sp. GN2-R2	2728020	S	1739	1073	2812	0.00044
Duganella sp. AF9R3	2728021	S	1214	476	1690	0.00026
Collimonas fungivorans	158899	S	1008	604	1612	0.00025
Collimonas arenae	279058	S	780	205	985	0.00015
Collimonas pratensis	279113	S	673	275	948	0.00015
Noviherbaspirillum sp. UKPF54	2601898	S	1768	645	2413	0.00037
Undibacterium parvum	401471	S	122	12	134	0.00002
Herminiimonas arsenitoxidans	1809410	S	183	39	222	0.00003
Glaciimonas sp. PAMC28666	2807626	S	152	11	163	0.00003
Sutterella megalosphaeroides	2494234	S	507	128	635	0.00010
Sutterella faecalis	2584944	S	420	103	523	0.00008
Sutterella wadsworthensis	40545	S	151	30	181	0.00003
Turicimonas muris	1796652	S	127	8	135	0.00002
Azoarcus sp. KH32C	748247	S	2437	913	3350	0.00052
Azoarcus sp. M9-3-2	2016596	S	2035	748	2783	0.00043
Azoarcus sp. DN11	356837	S	1965	1589	3554	0.00055
Azoarcus sp. DD4	2027405	S	1818	1327	3145	0.00049
Azoarcus sp. CIB	198107	S	1731	1422	3153	0.00049
Azoarcus olearius	418699	S	2075	1435	3510	0.00054
Azoarcus pumilus	2067960	S	1697	716	2413	0.00037
Azoarcus communis	41977	S	1501	538	2039	0.00032
Thauera sp. MZ1T	85643	S	2775	2417	5192	0.00080
Thauera sp. K11	2005884	S	2243	1446	3689	0.00057
Thauera humireducens	1134435	S	1708	1073	2781	0.00043
Thauera chlorobenzoica	96773	S	1124	1421	2545	0.00039
Thauera aromatica	59405	S	970	1258	2228	0.00035
Thauera hydrothermalis	2184083	S	621	217	838	0.00013
Aromatoleum petrolei	76116	S	2002	1382	3384	0.00052
Aromatoleum bremense	76115	S	1424	1186	2610	0.00040
Aromatoleum aromaticum	551760	S	1388	956	2344	0.00036
Azospira restricta	404405	S	3829	2401	6230	0.00097
Azospira sp. I09	1765049	S	298	709	1007	0.00016
Azospira oryzae	146939	S	280	813	1093	0.00017
Niveibacterium sp. HC41	2811415	S	1323	342	1665	0.00026
Oryzomicrobium terrae	1735038	S	1031	475	1506	0.00023
Rugosibacter aromaticivorans	1565605	S	234	42	276	0.00004
Dechloromonas sp. HYN0024	2231055	S	493	137	630	0.00010
Dechloromonas sp. TW-R-39-2	2654218	S	436	110	546	0.00008
Dechloromonas aromatica	259537	S	766	202	968	0.00015
Fluviibacter phosphoraccumulans	1751046	S	136	26	162	0.00003
Usitatibacter rugosus	2732067	S	7503	2328	9831	0.00152
Usitatibacter palustris	2732487	S	6707	2087	8794	0.00136
Denitratisoma sp. DHT3	1981880	S	1431	943	2374	0.00037
Denitratisoma oestradiolicum	311182	S	813	257	1070	0.00017
Sulfuritalea hydrogenivorans	748811	S	1940	757	2697	0.00042
Methyloversatilis sp. RAC08	1842540	S	1590	525	2115	0.00033
Sterolibacterium denitrificans	157592	S	1180	473	1653	0.00026
Nitrosomonas communis	44574	S	1299	47	1346	0.00021
Nitrosomonas ureae	44577	S	219	120	339	0.00005
Nitrosomonas sp. Is79A3	261292	S	123	8	131	0.00002
Nitrosomonas europaea	915	S	100	11	111	0.00002
Nitrosospira multiformis	1231	S	1246	111	1357	0.00021
Nitrosospira lacus	1288494	S	358	43	401	0.00006
Nitrosospira briensis	35799	S	290	41	331	0.00005
Thiobacillus denitrificans	36861	S	2192	815	3007	0.00047
Sulfuritortus calidifontis	1914471	S	1654	923	2577	0.00040
Sulfuriferula plumbiphila	171865	S	724	231	955	0.00015
Sulfuriferula sp. AH1	1985873	S	431	104	535	0.00008
Sulfurimicrobium lacus	2715678	S	1187	352	1539	0.00024
Sulfuricella denitrificans	649841	S	669	142	811	0.00013
Sideroxydans lithotrophicus	63745	S	813	198	1011	0.00016
Ferriphaselus amnicola	1188319	S	402	85	487	0.00008
Gallionella capsiferriformans	370405	S	216	30	246	0.00004
Candidatus Nitrotoga sp. AM1P	2559597	S	187	17	204	0.00003
Methylobacillus flagellatus	405	S	288	76	364	0.00006
Chromobacterium sp. ATCC 53434	2059672	S	852	510	1362	0.00021
Chromobacterium sp. Rain0013	2292447	S	233	398	631	0.00010
Chromobacterium vaccinii	1108595	S	850	665	1515	0.00023
Chromobacterium violaceum	536	S	793	855	1648	0.00026
Chromobacterium phragmitis	2202141	S	510	373	883	0.00014
Chromobacterium paludis	2605945	S	478	309	787	0.00012
Chromobacterium rhizoryzae	1778675	S	124	798	922	0.00014
Jeongeupia sp. USM3	1906741	S	1445	750	2195	0.00034
Jeongeupia sp. HS-3	1009682	S	579	227	806	0.00013
Pseudogulbenkiania sp. NH8B	748280	S	1386	717	2103	0.00033
Aquitalea aquatilis	1537400	S	237	115	352	0.00005
Aquitalea magnusonii	332411	S	204	133	337	0.00005
Aquitalea sp. USM4	1590041	S	178	111	289	0.00004
Aquitalea denitrificans	519081	S	164	99	263	0.00004
Microvirgula aerodenitrificans	57480	S	943	324	1267	0.00020
Vogesella sp. LIG4	1192162	S	878	400	1278	0.00020
Laribacter hongkongensis	168471	S	773	466	1239	0.00019
Aquaspirillum sp. LM1	1938604	S	456	128	584	0.00009
Neisseria sp. KEM232	655307	S	194	69	263	0.00004
Neisseria bacilliformis	267212	S	204	79	283	0.00004
Neisseria dentiae	194197	S	159	44	203	0.00003
Neisseria shayeganii	607712	S	150	40	190	0.00003
Neisseria elongata	495	S	138	103	241	0.00004
Neisseria chenwenguii	1853278	S	126	29	155	0.00002
Neisseria meningitidis	487	S	116	564	680	0.00011
Crenobacter cavernae	2290923	S	1633	951	2584	0.00040
Chitinolyticbacter meiyuanensis	682798	S	954	273	1227	0.00019
Vitreoscilla filiformis	63	S	634	222	856	0.00013
Eikenella corrodens	539	S	186	191	377	0.00006
Kingella oralis	505	S	127	25	152	0.00002
Kingella denitrificans	502	S	108	49	157	0.00002
Candidatus Accumulibacter phosphatis	327160	S	1664	298	1962	0.00030
Casimicrobium huifangae	2591109	S	1391	320	1711	0.00027
Pseudomonas sp. DY-1	1755504	S	4024	1093	5117	0.00079
Pseudomonas sp. TCU-HL1	1856685	S	1792	535	2327	0.00036
Pseudomonas sp. TUM18999	2725477	S	980	287	1267	0.00020
Pseudomonas sp. K2W31S-8	2320867	S	714	201	915	0.00014
Pseudomonas sp. S1-A32-2	2731681	S	546	130	676	0.00010
Pseudomonas sp. LPB0260	2614442	S	535	165	700	0.00011
Pseudomonas sp. SCB32	2653853	S	513	245	758	0.00012
Pseudomonas sp. ATCC 13867	1294143	S	487	283	770	0.00012
Pseudomonas sp. PDNC002	2811422	S	461	169	630	0.00010
Pseudomonas sp. CC6-YY-74	1930532	S	450	88	538	0.00008
Pseudomonas sp. ABC1	2748080	S	394	62	456	0.00007
Pseudomonas sp. 02C 26	2054914	S	339	74	413	0.00006
Pseudomonas sp. CMR5c	658630	S	319	456	775	0.00012
Pseudomonas sp. StFLB209	1028989	S	317	49	366	0.00006
Pseudomonas sp. BIGb0427	2724470	S	286	289	575	0.00009
Pseudomonas sp. S-6-2	1931241	S	271	25	296	0.00005
Pseudomonas sp. 7SR1	1881017	S	270	68	338	0.00005
Pseudomonas sp. SK	2729423	S	253	88	341	0.00005
Pseudomonas sp. B11D7D	2735906	S	251	74	325	0.00005
Pseudomonas sp. OIL-1	2706126	S	241	83	324	0.00005
Pseudomonas sp. R32	1573704	S	239	251	490	0.00008
Pseudomonas sp. SNU WT1	2518644	S	225	161	386	0.00006
Pseudomonas sp. MPC6	2498848	S	216	64	280	0.00004
Pseudomonas sp. LAB-08	143813	S	212	116	328	0.00005
Pseudomonas sp. MSPm1	2726956	S	211	63	274	0.00004
Pseudomonas sp. gcc21	2726989	S	209	81	290	0.00004
Pseudomonas sp. S34	1573718	S	199	88	287	0.00004
Pseudomonas sp. RtIB026	2749999	S	189	89	278	0.00004
Pseudomonas sp. HLS-6	2049589	S	188	40	228	0.00004
Pseudomonas sp. Leaf58	1736226	S	184	39	223	0.00003
Pseudomonas sp. DG56-2	2320270	S	181	33	214	0.00003
Pseudomonas sp. S09G 359	2054919	S	178	70	248	0.00004
Pseudomonas sp. ADPe	2774873	S	175	237	412	0.00006
Pseudomonas sp. URMO17WK12:I11	1283291	S	174	94	268	0.00004
Pseudomonas sp. 31-12	2201356	S	173	80	253	0.00004
Pseudomonas sp. 15A4	2804761	S	171	32	203	0.00003
Pseudomonas sp. ADAK13	2730847	S	158	60	218	0.00003
Pseudomonas sp. S35	1573719	S	135	72	207	0.00003
Pseudomonas sp. CCOS 191	1649877	S	134	114	248	0.00004
Pseudomonas sp. M30-35	1981174	S	133	8	141	0.00002
Pseudomonas sp. DTU12.3	2073078	S	132	83	215	0.00003
Pseudomonas sp. ADAK18	2730848	S	130	33	163	0.00003
Pseudomonas sp. Tri1	2823875	S	128	37	165	0.00003
Pseudomonas sp. LG1E9	2219057	S	121	80	201	0.00003
Pseudomonas sp. ACM7	2052956	S	120	44	164	0.00003
Pseudomonas sp. R5-89-07	658644	S	111	101	212	0.00003
Pseudomonas sp. LPH1	1898684	S	103	62	165	0.00003
Pseudomonas aeruginosa	287	S	2687	4162	6849	0.00106
Pseudomonas mendocina	300	S	1841	530	2371	0.00037
Pseudomonas resinovorans	53412	S	1742	383590	385332	0.05973
Pseudomonas furukawaii	1149133	S	1401	297	1698	0.00026
Pseudomonas oleovorans	301	S	153	188	341	0.00005
Pseudomonas alcaligenes	43263	S	1104	304	1408	0.00022
Pseudomonas nitroreducens	46680	S	404	156	560	0.00009
Pseudomonas multiresinivorans	95301	S	298	136	434	0.00007
Pseudomonas citronellolis	53408	S	509	319	828	0.00013
Pseudomonas fluorescens	294	S	3170	903	4073	0.00063
Pseudomonas protegens	380021	S	852	8336	9188	0.00142
Pseudomonas azotoformans	47878	S	467	102	569	0.00009
Pseudomonas orientalis	76758	S	422	73	495	0.00008
Pseudomonas synxantha	47883	S	298	92	390	0.00006
Pseudomonas poae	200451	S	262	82	344	0.00005
Pseudomonas trivialis	200450	S	253	51	304	0.00005
Pseudomonas corrugata	47879	S	233	37	270	0.00004
Pseudomonas mucidolens	46679	S	204	20	224	0.00003
Pseudomonas mediterranea	183795	S	201	37	238	0.00004
Pseudomonas rhodesiae	76760	S	197	35	232	0.00004
Pseudomonas tolaasii	29442	S	183	21	204	0.00003
Pseudomonas migulae	78543	S	176	73	249	0.00004
Pseudomonas cedrina	651740	S	150	26	176	0.00003
Pseudomonas brenneri	129817	S	111	22	133	0.00002
Pseudomonas extremorientalis	169669	S	107	29	136	0.00002
Pseudomonas putida	303	S	4902	1833	6735	0.00104
Pseudomonas oryzihabitans	47885	S	1085	206	1291	0.00020
Pseudomonas monteilii	76759	S	636	342	978	0.00015
Pseudomonas fulva	47880	S	496	931	1427	0.00022
Pseudomonas plecoglossicida	70775	S	270	100	370	0.00006
Pseudomonas stutzeri	316	S	5435	1462	6897	0.00107
Pseudomonas balearica	74829	S	760	328	1088	0.00017
Pseudomonas xanthomarina	271420	S	277	52	329	0.00005
Pseudomonas chlororaphis	587753	S	2385	1170	3555	0.00055
Pseudomonas lundensis	86185	S	170	15	185	0.00003
Pseudomonas fragi	296	S	119	29	148	0.00002
Pseudomonas lalkuanensis	2604832	S	2629	426	3055	0.00047
Pseudomonas syringae	317	S	735	1107	1842	0.00029
Pseudomonas viridiflava	33069	S	247	29	276	0.00004
Pseudomonas asturiensis	1190415	S	204	21	225	0.00003
Pseudomonas cichorii	36746	S	198	16	214	0.00003
Pseudomonas coronafaciens	53409	S	161	37	198	0.00003
Pseudomonas oryzae	1392877	S	1632	457	2089	0.00032
Pseudomonas otitidis	319939	S	1119	217	1336	0.00021
Pseudomonas psychrotolerans	237610	S	1079	201	1280	0.00020
Pseudomonas knackmussii	65741	S	950	328	1278	0.00020
Pseudomonas guangdongensis	1245526	S	834	240	1074	0.00017
Pseudomonas entomophila	312306	S	705	184	889	0.00014
Pseudomonas denitrificans (nom. rej.)	43306	S	528	102	630	0.00010
Pseudomonas parafulva	157782	S	436	75	511	0.00008
Pseudomonas eucalypticola	2599595	S	432	50	482	0.00007
Pseudomonas xinjiangensis	487184	S	396	29	425	0.00007
Pseudomonas frederiksbergensis	104087	S	389	51	440	0.00007
Pseudomonas alkylphenolica	237609	S	377	46	423	0.00007
Pseudomonas rhizosphaerae	216142	S	329	42	371	0.00006
Pseudomonas saudiphocaensis	1499686	S	327	38	365	0.00006
Pseudomonas sabulinigri	472181	S	326	22	348	0.00005
Pseudomonas pohangensis	364197	S	310	25	335	0.00005
Pseudomonas cremoricolorata	157783	S	309	40	349	0.00005
Pseudomonas umsongensis	198618	S	291	31	322	0.00005
Pseudomonas brassicacearum	930166	S	271	109	380	0.00006
Pseudomonas koreensis	198620	S	270	45	315	0.00005
Pseudomonas pelagia	553151	S	253	14	267	0.00004
Pseudomonas yamanorum	515393	S	251	29	280	0.00004
Pseudomonas moraviensis	321662	S	245	49	294	0.00005
Pseudomonas litoralis	797277	S	241	19	260	0.00004
Pseudomonas vancouverensis	95300	S	230	25	255	0.00004
Pseudomonas arsenicoxydans	702115	S	226	19	245	0.00004
Pseudomonas marincola	437900	S	218	16	234	0.00004
Pseudomonas sediminis	1691904	S	217	41	258	0.00004
Pseudomonas antarctica	219572	S	211	26	237	0.00004
Pseudomonas thivervalensis	86265	S	207	27	234	0.00004
Pseudomonas prosekii	1148509	S	198	20	218	0.00003
Pseudomonas extremaustralis	359110	S	196	25	221	0.00003
Pseudomonas silesiensis	1853130	S	193	23	216	0.00003
Pseudomonas palleroniana	191390	S	189	18	207	0.00003
Pseudomonas reinekei	395598	S	183	19	202	0.00003
Pseudomonas alcaliphila	101564	S	182	68	250	0.00004
Pseudomonas salegens	1434072	S	178	10	188	0.00003
Pseudomonas lurida	244566	S	171	24	195	0.00003
Pseudomonas simiae	321846	S	153	21	174	0.00003
Pseudomonas agarici	46677	S	153	9	162	0.00003
Pseudomonas sihuiensis	1274359	S	149	54	203	0.00003
Pseudomonas granadensis	1421430	S	148	29	177	0.00003
Pseudomonas viciae	2505979	S	144	19	163	0.00003
Pseudomonas taetrolens	47884	S	142	11	153	0.00002
Pseudomonas toyotomiensis	554344	S	133	50	183	0.00003
Pseudomonas lini	163011	S	133	14	147	0.00002
Pseudomonas graminis	158627	S	130	19	149	0.00002
Pseudomonas allokribbensis	2774460	S	127	21	148	0.00002
Pseudomonas gozinkensis	2774461	S	109	21	130	0.00002
Pseudomonas khazarica	2502979	S	108	59	167	0.00003
Pseudomonas versuta	1788301	S	105	9	114	0.00002
Azotobacter chroococcum	353	S	2664	1449	4113	0.00064
Azotobacter salinestris	69964	S	746	307	1053	0.00016
Azotobacter vinelandii	354	S	726	0	726	0.00011
Permianibacter aggregans	1510150	S	445	17	462	0.00007
Lysobacter soli	453783	S	7746	3378	11124	0.00172
Lysobacter sp. TY2-98	2290922	S	1754	520	2274	0.00035
Lysobacter sp. CW239	2762611	S	1005	476	1481	0.00023
Lysobacter sp. H21R4	2781021	S	290	460	750	0.00012
Lysobacter sp. H21R20	2781022	S	252	407	659	0.00010
Lysobacter sp. HDW10	2714936	S	169	14	183	0.00003
Lysobacter sp. H23M47	2781024	S	140	419	559	0.00009
Lysobacter sp. H23M41	2781023	S	114	335	449	0.00007
Lysobacter enzymogenes	69	S	4043	2426	6469	0.00100
Lysobacter solisilvae	2763317	S	3798	1648	5446	0.00084
Lysobacter arenosi	2795387	S	1888	875	2763	0.00043
Lysobacter antibioticus	84531	S	1526	771	2297	0.00036
Lysobacter capsici	435897	S	1476	844	2320	0.00036
Lysobacter maris	1605891	S	1351	640	1991	0.00031
Lysobacter lycopersici	1324796	S	1305	563	1868	0.00029
Lysobacter gummosus	262324	S	1197	722	1919	0.00030
Lysobacter alkalisoli	2591633	S	1142	441	1583	0.00025
Lysobacter oculi	2698682	S	860	383	1243	0.00019
Stenotrophomonas maltophilia	40324	S	3921	6975	10896	0.00169
Stenotrophomonas sp. ESTM1D_MKCIP4_1	2072414	S	308	301	609	0.00009
Stenotrophomonas sp. SAU14A_NAIMI4_5	2072413	S	282	401	683	0.00011
Stenotrophomonas sp. ZAC14D2_NAIMI4_7	2072405	S	144	362	506	0.00008
Stenotrophomonas sp. YAU14D1_LEIMI4_1	2072407	S	125	512	637	0.00010
Stenotrophomonas sp. LM091	1904944	S	508	303	811	0.00013
Stenotrophomonas sp. 169	2770322	S	461	144	605	0.00009
Stenotrophomonas sp. 364	2691571	S	360	292	652	0.00010
Stenotrophomonas sp. NA06056	2742129	S	200	196	396	0.00006
Stenotrophomonas sp. G4	2303750	S	105	245	350	0.00005
Stenotrophomonas rhizophila	216778	S	1603	966	2569	0.00040
Stenotrophomonas acidaminiphila	128780	S	929	2261	3190	0.00049
Xanthomonas campestris	339	S	1202	1396	2598	0.00040
Xanthomonas sp. SS	2724122	S	162	490	652	0.00010
Xanthomonas sp. SI	2724123	S	159	473	632	0.00010
Xanthomonas sp. GW	2724121	S	158	395	553	0.00009
Xanthomonas translucens	343	S	961	1394	2355	0.00037
Xanthomonas sacchari	56458	S	807	462	1269	0.00020
Xanthomonas oryzae	347	S	679	727	1406	0.00022
Xanthomonas theicola	56464	S	595	336	931	0.00014
Xanthomonas citri	346	S	589	5356	5945	0.00092
Xanthomonas albilineans	29447	S	490	132	622	0.00010
Xanthomonas hyacinthi	56455	S	469	385	854	0.00013
Xanthomonas arboricola	56448	S	383	828	1211	0.00019
Xanthomonas vesicatoria	56460	S	372	305	677	0.00011
Xanthomonas cucurbitae	56453	S	331	139	470	0.00007
Xanthomonas fragariae	48664	S	325	84	409	0.00006
Xanthomonas hortorum	56454	S	313	484	797	0.00012
Xanthomonas vasicola	56459	S	256	196	452	0.00007
Xanthomonas cassavae	56450	S	244	140	384	0.00006
Xanthomonas axonopodis	53413	S	225	707	932	0.00014
Xanthomonas euroxanthea	2259622	S	150	336	486	0.00008
Luteimonas sp. MC1750	2799326	S	1299	764	2063	0.00032
Luteimonas sp. JM171	1896164	S	1049	374	1423	0.00022
Luteimonas sp. YGD11-2	2508168	S	1004	655	1659	0.00026
Luteimonas sp. MC1572	2799325	S	983	740	1723	0.00027
Luteimonas sp. MC1825	2761107	S	913	718	1631	0.00025
Luteimonas granuli	1176533	S	1268	703	1971	0.00031
Luteimonas chenhongjianii	2006110	S	1222	415	1637	0.00025
Luteimonas yindakuii	2565782	S	1000	646	1646	0.00026
Pseudoxanthomonas suwonensis	314722	S	3286	2530	5816	0.00090
Pseudoxanthomonas mexicana	128785	S	2181	1080	3261	0.00051
Pseudoxanthomonas spadix	415229	S	795	362	1157	0.00018
Thermomonas sp. SY21	2202149	S	1135	815	1950	0.00030
Thermomonas sp. XSG	2771436	S	1037	647	1684	0.00026
Thermomonas sp. HDW16	2714945	S	706	404	1110	0.00017
Thermomonas brevis	215691	S	1258	817	2075	0.00032
Thermomonas carbonis	1463158	S	1026	402	1428	0.00022
Arenimonas daejeonensis	370777	S	3430	1162	4592	0.00071
Pseudolysobacter antarcticus	2511995	S	823	52	875	0.00014
Xylella fastidiosa	2371	S	121	23	144	0.00002
Dyella thiooxydans	445710	S	1337	553	1890	0.00029
Dyella sp. G9	2763498	S	728	266	994	0.00015
Dyella sp. M7H15-1	2501295	S	278	43	321	0.00005
Dyella japonica	231455	S	843	322	1165	0.00018
Dyella caseinilytica	1849581	S	409	58	467	0.00007
Rhodanobacter denitrificans	666685	S	1405	698	2103	0.00033
Rhodanobacter sp. FDAARGOS 1247	2778082	S	1112	588	1700	0.00026
Rhodanobacter glycinis	582702	S	746	250	996	0.00015
Dokdonella koreensis	323415	S	2677	766	3443	0.00053
Luteibacter pinisoli	2589080	S	940	248	1188	0.00018
Luteibacter rhizovicinus	242606	S	905	191	1096	0.00017
Aerosticca soli	2010829	S	1263	663	1926	0.00030
Ahniella affigens	2021234	S	839	36	875	0.00014
Frateuria aurantia	81475	S	479	78	557	0.00009
Enterobacter cloacae	550	S	553	592	1145	0.00018
Enterobacter hormaechei	158836	S	201	1477	1678	0.00026
Enterobacter cancerogenus	69218	S	125	27	152	0.00002
Enterobacter asburiae	61645	S	106	313	419	0.00006
Enterobacter sp. JUb54	2724468	S	145	24	169	0.00003
Enterobacter sp. E76	2596949	S	127	42	169	0.00003
Enterobacter sp. SA187	1914861	S	115	19	134	0.00002
Klebsiella pneumoniae	573	S	474	3589	4063	0.00063
Klebsiella aerogenes	548	S	328	80	408	0.00006
Klebsiella oxytoca	571	S	208	104	312	0.00005
Klebsiella michiganensis	1134687	S	202	361	563	0.00009
Klebsiella quasipneumoniae	1463165	S	199	668	867	0.00013
Klebsiella variicola	244366	S	102	302	404	0.00006
Citrobacter freundii	546	S	204	947	1151	0.00018
Citrobacter rodentium	67825	S	112	79	191	0.00003
Cronobacter sakazakii	28141	S	171	214	385	0.00006
Cronobacter dublinensis	413497	S	146	73	219	0.00003
Cronobacter universalis	535744	S	121	141	262	0.00004
Cronobacter condimenti	1163710	S	102	32	134	0.00002
Kosakonia cowanii	208223	S	123	281	404	0.00006
Leclercia adecarboxylata	83655	S	183	372	555	0.00009
Escherichia coli	562	S	418	5669	6087	0.00094
Pluralibacter gergoviae	61647	S	419	201	620	0.00010
[Enterobacter] lignolyticus	1334193	S	182	39	221	0.00003
Salmonella enterica	28901	S	377	4906	5283	0.00082
Cedecea neteri	158822	S	331	64	395	0.00006
Lelliottia amnigena	61646	S	144	24	168	0.00003
Pseudescherichia vulneris	566	S	142	15	157	0.00002
Jejubacter calystegiae	2579935	S	137	12	149	0.00002
Yokenella regensburgei	158877	S	113	19	132	0.00002
Scandinavium goeteborgense	1851514	S	107	11	118	0.00002
Serratia marcescens	615	S	736	2291	3027	0.00047
Serratia plymuthica	82996	S	297	286	583	0.00009
Serratia rubidaea	61652	S	167	381	548	0.00008
Serratia odorifera	618	S	153	28	181	0.00003
Serratia fonticola	47917	S	150	97	247	0.00004
Serratia surfactantfaciens	2741499	S	123	149	272	0.00004
Serratia proteamaculans	28151	S	121	80	201	0.00003
Nissabacter sp. SGAir0207	2126321	S	342	44	386	0.00006
Rahnella aquatilis	34038	S	100	168	268	0.00004
Gibbsiella quercinecans	929813	S	195	29	224	0.00003
Rouxiella badensis	1646377	S	126	10	136	0.00002
Ewingella americana	41202	S	110	12	122	0.00002
Pantoea sp. SO10	2575375	S	138	23	161	0.00003
Pantoea sp. At-9b	592316	S	105	37	142	0.00002
Pantoea sp. PSNIH1	1484158	S	101	37	138	0.00002
Pantoea dispersa	59814	S	314	68	382	0.00006
Pantoea vagans	470934	S	206	216	422	0.00007
Pantoea agglomerans	549	S	168	47	215	0.00003
Pantoea ananatis	553	S	146	22	168	0.00003
Pantoea cypripedii	55209	S	115	13	128	0.00002
Pantoea stewartii	66269	S	110	22	132	0.00002
Erwinia gerundensis	1619313	S	185	56	241	0.00004
Erwinia persicina	55211	S	112	147	259	0.00004
Mixta gaviniae	665914	S	195	56	251	0.00004
Mixta calida	665913	S	156	60	216	0.00003
Mixta theicola	1458355	S	151	40	191	0.00003
Mixta intestinalis	1615494	S	108	22	130	0.00002
Buchnera aphidicola	9	S	192	27	219	0.00003
Dickeya zeae	204042	S	241	111	352	0.00005
Dickeya chrysanthemi	556	S	181	122	303	0.00005
Dickeya dadantii	204038	S	143	362	505	0.00008
Dickeya paradisiaca	69223	S	135	112	247	0.00004
Dickeya dianthicola	204039	S	124	141	265	0.00004
Brenneria sp. Ir50	2722756	S	154	174	328	0.00005
Brenneria goodwinii	1109412	S	105	115	220	0.00003
Lonsdalea populi	1172565	S	132	34	166	0.00003
Lonsdalea britannica	1082704	S	112	26	138	0.00002
Edwardsiella tarda	636	S	199	506	705	0.00011
Edwardsiella hoshinae	93378	S	103	31	134	0.00002
Morganella morganii	582	S	157	41	198	0.00003
Sodalis praecaptivus	1239307	S	124	118	242	0.00004
Plesiomonas shigelloides	703	S	122	20	142	0.00002
Thioalkalivibrio nitratireducens	186931	S	1202	432	1634	0.00025
Thioalkalivibrio sulfidiphilus	1033854	S	1198	333	1531	0.00024
Thioalkalivibrio paradoxus	108010	S	1057	417	1474	0.00023
Thioalkalivibrio sp. K90mix	396595	S	695	130	825	0.00013
Thioalkalivibrio versutus	106634	S	686	155	841	0.00013
Acidihalobacter ferrooxydans	1765967	S	866	113	979	0.00015
Acidihalobacter aeolianus	2792603	S	846	158	1004	0.00016
Acidihalobacter yilgarnenesis	2819280	S	465	61	526	0.00008
Spiribacter curvatus	1335757	S	577	63	640	0.00010
Spiribacter sp. 2438	2666185	S	495	65	560	0.00009
Spiribacter salinus	1335746	S	335	35	370	0.00006
Halorhodospira halophila	1053	S	955	175	1130	0.00018
Halorhodospira halochloris	1052	S	163	8	171	0.00003
Aquisalimonas sp. 2447	2740807	S	1030	141	1171	0.00018
Alkalilimnicola ehrlichii	351052	S	984	216	1200	0.00019
Ectothiorhodospira haloalkaliphila	421628	S	358	169	527	0.00008
Ectothiorhodospira sp. BSL-9	1442136	S	349	157	506	0.00008
Candidatus Thiodictyon syntrophicum	1166950	S	1658	161	1819	0.00028
Thioflavicoccus mobilis	80679	S	1530	234	1764	0.00027
Marichromatium purpuratum	37487	S	1444	384	1828	0.00028
Allochromatium vinosum	1049	S	1047	375	1422	0.00022
Thiocystis violascens	73141	S	953	131	1084	0.00017
Thermochromatium tepidum	1050	S	667	229	896	0.00014
Nitrosococcus halophilus	133539	S	122	54	176	0.00003
Nitrosococcus wardiae	1814290	S	104	45	149	0.00002
Caldichromatium japonicum	2699430	S	460	57	517	0.00008
Wenzhouxiangella marina	1579979	S	981	114	1095	0.00017
Wenzhouxiangella sp. AB-CW3	2771012	S	676	69	745	0.00012
Thiohalobacter sp. COW1	2795687	S	312	788	1100	0.00017
Thiohalobacter thiocyanaticus	585455	S	159	523	682	0.00011
Sulfurivermis fontis	1972068	S	1075	295	1370	0.00021
Guyparkeria halophila	47960	S	1033	248	1281	0.00020
Halothiobacillus sp. LS2	1860122	S	405	47	452	0.00007
Halothiobacillus neapolitanus	927	S	191	14	205	0.00003
Woeseia oceani	1548547	S	576	19	595	0.00009
Sulfuriflexus mobilis	1811807	S	269	15	284	0.00004
Granulosicoccus antarcticus	437505	S	229	4	233	0.00004
Halomonas sp. THAF5a	2587844	S	784	596	1380	0.00021
Halomonas sp. YLGW01	2773308	S	546	189	735	0.00011
Halomonas sp. THAF12	2587849	S	546	595	1141	0.00018
Halomonas sp. 1513	1883416	S	546	386	932	0.00014
Halomonas sp. MCCC 1A13718	2733488	S	541	305	846	0.00013
Halomonas sp. MCCC 1A13316	2733487	S	537	202	739	0.00011
Halomonas sp. BC-M4-5	2497861	S	528	318	846	0.00013
Halomonas sp. HG01	1609967	S	485	486	971	0.00015
Halomonas sp. JS92-SW72	2306583	S	411	751	1162	0.00018
Halomonas sp. PGE1	2730360	S	311	642	953	0.00015
Halomonas sp. Y2R2	2562282	S	231	21	252	0.00004
Halomonas sp. SH5A2	2749040	S	166	58	224	0.00003
Halomonas sp. A40-4	2785909	S	145	60	205	0.00003
Halomonas sp. KO116	1504981	S	104	128	232	0.00004
Halomonas beimenensis	475662	S	786	415	1201	0.00019
Halomonas aestuarii	1897729	S	637	391	1028	0.00016
Halomonas socia	1081866	S	477	295	772	0.00012
Halomonas elongata	2746	S	468	132	600	0.00009
Halomonas chromatireducens	507626	S	412	119	531	0.00008
Halomonas hydrothermalis	115561	S	296	596	892	0.00014
Halomonas subglaciescola	29571	S	284	49	333	0.00005
Halomonas huangheensis	1178482	S	272	28	300	0.00005
Halomonas meridiana	29570	S	270	214	484	0.00008
Halomonas piezotolerans	2609667	S	141	132	273	0.00004
Cobetia sp. L2A1	2686360	S	204	98	302	0.00005
Cobetia sp. cqz5-12	2609415	S	109	690	799	0.00012
Halotalea alkalilenta	376489	S	860	153	1013	0.00016
Salinicola tamaricis	1771309	S	824	207	1031	0.00016
Kushneria phosphatilytica	657387	S	208	19	227	0.00004
Kushneria konosiri	698828	S	196	54	250	0.00004
Kushneria marisflavi	157779	S	191	50	241	0.00004
Chromohalobacter salexigens	158080	S	576	145	721	0.00011
Pistricoccus aurantiacus	1883414	S	436	75	511	0.00008
Alcanivorax sp. N3-2A	2014542	S	656	228	884	0.00014
Alcanivorax pacificus	1306787	S	501	66	567	0.00009
Alcanivorax dieselolei	285091	S	318	189	507	0.00008
Alcanivorax xenomutans	1094342	S	290	197	487	0.00008
Ketobacter alkanivorans	1917421	S	106	7	113	0.00002
Marinobacterium aestuarii	1821621	S	395	31	426	0.00007
Marinobacterium georgiense	48076	S	153	16	169	0.00003
Hahella sp. KA22	1628392	S	224	32	256	0.00004
Hahella chejuensis	158327	S	219	30	249	0.00004
Saccharospirillum mangrovi	2161747	S	300	21	321	0.00005
Reinekea forsetii	1336806	S	140	6	146	0.00002
Litoricola lipolytica	418701	S	131	7	138	0.00002
Marinobacter sp. Arc7-DN-1	2304594	S	270	60	330	0.00005
Marinobacter sp. LPB0319	2769486	S	221	24	245	0.00004
Marinobacter sp. NP-4(2019)	2488665	S	193	43	236	0.00004
Marinobacter sp. LQ44	1749259	S	137	198	335	0.00005
Marinobacter sp. es.042	1761794	S	110	216	326	0.00005
Marinobacter sp. LV10R510-11A	1415568	S	100	8	108	0.00002
Marinobacter fonticola	2603215	S	332	26	358	0.00006
Marinobacter hydrocarbonoclasticus	2743	S	254	76	330	0.00005
Marinobacter salarius	1420917	S	206	41	247	0.00004
Marinobacter salsuginis	418719	S	168	59	227	0.00004
Marinobacter salinus	1874317	S	159	19	178	0.00003
Hydrocarboniclastica marina	2259620	S	265	28	293	0.00005
Shewanella loihica	359303	S	164	94	258	0.00004
Shewanella khirikhana	1965282	S	116	65	181	0.00003
Shewanella algae	38313	S	110	341	451	0.00007
Ferrimonas balearica	44012	S	236	56	292	0.00005
Aeromonas veronii	654	S	644	471	1115	0.00017
Aeromonas hydrophila	644	S	636	1473	2109	0.00033
Aeromonas media	651	S	384	322	706	0.00011
Aeromonas schubertii	652	S	356	65	421	0.00007
Aeromonas sp. CA23	2033032	S	118	63	181	0.00003
Aeromonas encheleia	73010	S	292	102	394	0.00006
Aeromonas salmonicida	645	S	283	193	476	0.00007
Aeromonas simiae	218936	S	260	66	326	0.00005
Aeromonas caviae	648	S	234	960	1194	0.00019
Aeromonas jandaei	650	S	176	176	352	0.00005
Aeromonas dhakensis	196024	S	147	219	366	0.00006
Zobellella denitrificans	347534	S	658	159	817	0.00013
Oceanimonas sp. GK1	511062	S	343	71	414	0.00006
Dongshaea marina	2047966	S	114	5	119	0.00002
Methylococcus sp. EFPC2	2812648	S	916	85	1001	0.00016
Methylococcus sp. IM1	2681310	S	849	182	1031	0.00016
Methylococcus capsulatus	414	S	818	157	975	0.00015
Methylomonas sp. LL1	2785785	S	272	19	291	0.00005
Methylomonas sp. DH-1	1727196	S	113	157	270	0.00004
Methylomonas sp. LW13	107637	S	101	89	190	0.00003
Methylomonas rhizoryzae	2608981	S	254	13	267	0.00004
Methylomonas denitrificans	1538553	S	223	26	249	0.00004
Methylomonas methanica	421	S	178	10	188	0.00003
Methylomonas koyamae	702114	S	141	205	346	0.00005
Methylomicrobium album	39775	S	815	57	872	0.00014
Methylomicrobium sp. wino1	2049332	S	150	91	241	0.00004
Methylocaldum marinum	1432792	S	878	48	926	0.00014
Candidatus Methylospira mobilis	1808979	S	345	15	360	0.00006
Methylotuvimicrobium alcaliphilum	271065	S	102	130	232	0.00004
Methylovulum psychrotolerans	1704499	S	127	3	130	0.00002
Sulfurifustis variabilis	1675686	S	4328	533	4861	0.00075
Sulfuricaulis limicola	1620215	S	1769	241	2010	0.00031
Acidiferrobacter sp. SPIII_3	1281578	S	768	41	809	0.00013
Solimonas sp. K1W22B-7	2303331	S	3461	567	4028	0.00062
Sinimarinibacterium sp. NLF-5-8	2698684	S	600	68	668	0.00010
Steroidobacter denitrificans	465721	S	2328	185	2513	0.00039
Microbulbifer sp. SH-1	2681547	S	322	56	378	0.00006
Microbulbifer sp. YPW1	2745199	S	239	104	343	0.00005
Microbulbifer sp. ALW1	1516059	S	198	39	237	0.00004
Microbulbifer aggregans	1769779	S	326	40	366	0.00006
Microbulbifer thermotolerans	252514	S	225	20	245	0.00004
Microbulbifer hydrolyticus	48074	S	211	39	250	0.00004
Microbulbifer agarilyticus	260552	S	124	15	139	0.00002
Cellvibrio sp. KY-YJ-3	454662	S	732	77	809	0.00013
Cellvibrio sp. PSBB006	1987723	S	232	10	242	0.00004
Cellvibrio japonicus	155077	S	138	10	148	0.00002
Teredinibacter turnerae	2426	S	107	5	112	0.00002
Simiduia agarivorans	447471	S	191	14	205	0.00003
Halioglobus pacificus	930806	S	304	16	320	0.00005
Halioglobus japonicus	930805	S	262	25	287	0.00004
Halioglobus maricola	2601894	S	241	21	262	0.00004
Kineobactrum salinum	2708301	S	568	42	610	0.00009
Congregibacter litoralis	393662	S	257	42	299	0.00005
Spongiibacter sp. CSC3.9	2794344	S	206	20	226	0.00004
Vibrio parahaemolyticus	670	S	105	111	216	0.00003
Vibrio fluvialis	676	S	163	79	242	0.00004
Vibrio furnissii	29494	S	140	92	232	0.00004
Vibrio vulnificus	672	S	127	56	183	0.00003
Vibrio anguillarum	55601	S	111	165	276	0.00004
Immundisolibacter cernigliae	1810504	S	1847	313	2160	0.00033
Legionella pneumophila	446	S	116	171	287	0.00004
Aquicella siphonis	254247	S	142	79	221	0.00003
Thiothrix sp.	1032	S	195	51	246	0.00004
Thiothrix sp. Ku-5	2735563	S	115	21	136	0.00002
Sedimenticola thiotaurini	1543721	S	364	23	387	0.00006
Candidatus Reidiella endopervernicosa	2738883	S	246	10	256	0.00004
Thiolapillus brandeum	1076588	S	206	12	218	0.00003
Pseudohongiella spirulinae	1249552	S	142	5	147	0.00002
Gallaecimonas mangrovi	2291597	S	119	5	124	0.00002
Salinisphaera sp. LB1	2183911	S	1084	94	1178	0.00018
endosymbiont of unidentified scaly snail isolate Monju	1248727	S	871	118	989	0.00015
Cardiobacterium hominis	2718	S	348	31	379	0.00006
Anaeromyxobacter sp. Fw109-5	404589	S	16255	3853	20108	0.00312
Anaeromyxobacter sp. K	447217	S	1448	4076	5524	0.00086
Anaeromyxobacter dehalogenans	161493	S	5231	6612	11843	0.00184
Archangium violaceum	83451	S	9600	4477	14077	0.00218
Archangium gephyra	48	S	4872	2555	7427	0.00115
Cystobacter fuscus	43	S	3044	1555	4599	0.00071
Stigmatella aurantiaca	41	S	3017	895	3912	0.00061
Melittangium boletus	83453	S	2458	1239	3697	0.00057
Myxococcus xanthus	34	S	3113	2213	5326	0.00083
Myxococcus hansupus	1297742	S	1740	1026	2766	0.00043
Myxococcus stipitatus	83455	S	1510	1235	2745	0.00043
Myxococcus sp. SCHIC003	2813577	S	1311	1047	2358	0.00037
Corallococcus coralloides	184914	S	4494	2263	6757	0.00105
Corallococcus macrosporus	35	S	1964	2804	4768	0.00074
Pyxidicoccus sp. SCPEA002	2813578	S	3923	1350	5273	0.00082
Vulgatibacter incomptus	1391653	S	3066	523	3589	0.00056
Sorangium cellulosum	56	S	37053	9888	46941	0.00728
Chondromyces crocatus	52	S	4190	543	4733	0.00073
Sandaracinus amylolyticus	927083	S	9131	1312	10443	0.00162
Minicystis rosea	888845	S	8939	1397	10336	0.00160
Labilithrix luteola	1391654	S	5523	484	6007	0.00093
Haliangium ochraceum	80816	S	6497	907	7404	0.00115
Geobacter sp. M18	443143	S	1414	729	2143	0.00033
Geobacter sp. FeAm09	2597769	S	868	192	1060	0.00016
Geobacter sp. M21	443144	S	582	579	1161	0.00018
Geobacter sp. SVR	2495594	S	569	98	667	0.00010
Geobacter sp. DSM 9736	1277350	S	413	32	445	0.00007
Geobacter sp. Jerry-YX	2815309	S	319	76	395	0.00006
Geobacter pickeringii	345632	S	924	256	1180	0.00018
Geobacter sulfurreducens	35554	S	877	409	1286	0.00020
Geobacter bremensis	60035	S	705	406	1111	0.00017
Geobacter metallireducens	28232	S	628	158	786	0.00012
Geobacter bemidjiensis	225194	S	602	598	1200	0.00019
Geobacter uraniireducens	351604	S	516	53	569	0.00009
Geobacter daltonii	1203471	S	311	25	336	0.00005
Geobacter lovleyi	313985	S	289	35	324	0.00005
Geoalkalibacter subterraneus	483547	S	382	219	601	0.00009
Desulfuromonas sp. DDH964	1823759	S	1178	289	1467	0.00023
Desulfuromonas soudanensis	1603606	S	992	170	1162	0.00018
Pelobacter propionicus	29543	S	631	177	808	0.00013
Syntrophotalea acetylenica	29542	S	363	80	443	0.00007
Syntrophotalea carbinolica	19	S	261	28	289	0.00004
Syntrophotalea acetylenivorans	1842532	S	224	37	261	0.00004
Desulfovibrio vulgaris	881	S	1245	151	1396	0.00022
Desulfovibrio marinus	370038	S	1010	147	1157	0.00018
Desulfovibrio carbinoliphilus	345370	S	880	200	1080	0.00017
Desulfovibrio sp. IOR2	2583823	S	452	114	566	0.00009
Desulfovibrio sp. 86	2666132	S	180	28	208	0.00003
Desulfovibrio gigas	879	S	499	61	560	0.00009
Desulfovibrio sulfodismutans	63561	S	496	189	685	0.00011
Desulfovibrio magneticus	184917	S	476	417	893	0.00014
Desulfovibrio piger	901	S	467	103	570	0.00009
Desulfovibrio carbinolicus	296842	S	410	417	827	0.00013
Desulfovibrio desulfuricans	876	S	408	339	747	0.00012
Desulfovibrio fairfieldensis	44742	S	331	45	376	0.00006
Desulfovibrio ferrophilus	241368	S	199	19	218	0.00003
Desulfovibrio alaskensis	58180	S	161	135	296	0.00005
Pseudodesulfovibrio indicus	1716143	S	648	232	880	0.00014
Pseudodesulfovibrio mercurii	641491	S	642	253	895	0.00014
Pseudodesulfovibrio aespoeensis	182210	S	490	275	765	0.00012
Pseudodesulfovibrio cashew	2678688	S	407	93	500	0.00008
Pseudodesulfovibrio sp. zrk46	2725288	S	164	21	185	0.00003
Pseudodesulfovibrio profundus	57320	S	136	87	223	0.00003
Desulfocurvibacter africanus	873	S	845	138	983	0.00015
Desulfolutivibrio sulfoxidireducens	2773299	S	572	271	843	0.00013
Desulfomicrobium baculatum	899	S	480	94	574	0.00009
Desulfomicrobium orale	132132	S	314	129	443	0.00007
Desulfohalobium retbaense	45663	S	126	10	136	0.00002
Desulfosarcina alkanivorans	571177	S	598	212	810	0.00013
Desulfosarcina ovata	83564	S	586	61	647	0.00010
Desulfosarcina widdelii	947919	S	485	72	557	0.00009
Desulfococcus multivorans	897	S	412	98	510	0.00008
Desulfococcus oleovorans	181663	S	345	63	408	0.00006
Desulfatibacillum aliphaticivorans	218208	S	371	31	402	0.00006
Desulfonema magnum	45655	S	118	5	123	0.00002
Desulfobacterium autotrophicum	2296	S	108	19	127	0.00002
Desulfobulbus propionicus	894	S	470	71	541	0.00008
Desulfobulbus oralis	1986146	S	343	122	465	0.00007
Desulfobulbus oligotrophicus	1909699	S	101	57	158	0.00002
Desulfurivibrio alkaliphilus	427923	S	313	40	353	0.00005
Persicimonas caeni	2292766	S	2240	216	2456	0.00038
Bradymonas sediminis	1548548	S	850	96	946	0.00015
Syntrophobacter fumaroxidans	119484	S	695	219	914	0.00014
Desulfoglaeba alkanexedens	361111	S	592	71	663	0.00010
Desulfomonile tiedjei	2358	S	267	8	275	0.00004
Desulfobacca acetoxidans	60893	S	221	15	236	0.00004
Syntrophus aciditrophicus	316277	S	210	22	232	0.00004
Desulfarculus baarsii	453230	S	1039	616	1655	0.00026
Helicobacter pylori	210	S	118	205	323	0.00005
Nitratifractor salsuginis	269261	S	164	26	190	0.00003
Hydrogenimonas urashimensis	2740515	S	211	35	246	0.00004
Acidithiobacillus caldus	33059	S	366	61	427	0.00007
Acidithiobacillus ferrivorans	160808	S	272	62	334	0.00005
Acidithiobacillus ferrooxidans	920	S	166	234	400	0.00006
Bdellovibrio bacteriovorus	959	S	264	71	335	0.00005
Hydrogenophilus thermoluteolus	297	S	546	78	624	0.00010
Mariprofundus ferrinatatus	1921087	S	171	13	184	0.00003
Mariprofundus aestuarium	1921086	S	110	7	117	0.00002
Streptomyces sp. WAC 01438	2203204	S	4563	2758	7321	0.00114
Streptomyces sp. CdTB01	1725411	S	2280	1151	3431	0.00053
Streptomyces sp. ZYC-3	2797636	S	2277	1018	3295	0.00051
Streptomyces sp. CRXT-G-22	2768066	S	2200	841	3041	0.00047
Streptomyces sp. SN-593	659352	S	2190	854	3044	0.00047
Streptomyces sp. TLI_053	1855352	S	2141	975	3116	0.00048
Streptomyces sp. SCSIO 3032	1264596	S	2100	804	2904	0.00045
Streptomyces sp. CB01881	2078691	S	2010	888	2898	0.00045
Streptomyces sp. NHF165	2175864	S	1952	694	2646	0.00041
Streptomyces sp. So13.3	2136173	S	1948	664	2612	0.00041
Streptomyces sp. CRXT-Y-14	2768069	S	1913	869	2782	0.00043
Streptomyces sp. P3	2135430	S	1821	869	2690	0.00042
Streptomyces sp. Z423-1	2730915	S	1819	962	2781	0.00043
Streptomyces sp. 3214.6	1882757	S	1774	927	2701	0.00042
Streptomyces sp. M2	646637	S	1769	918	2687	0.00042
Streptomyces sp. NA02950	2742137	S	1644	619	2263	0.00035
Streptomyces sp. SCUT-3	2684469	S	1637	923	2560	0.00040
Streptomyces sp. QMT-12	2717324	S	1583	648	2231	0.00035
Streptomyces sp. W1SF4	2305220	S	1560	886	2446	0.00038
Streptomyces sp. HM190	2695266	S	1468	786	2254	0.00035
Streptomyces sp. CRPJ-33	2768068	S	1465	720	2185	0.00034
Streptomyces sp. YIM 121038	2136401	S	1455	687	2142	0.00033
Streptomyces sp. SAT1	1849967	S	1433	793	2226	0.00035
Streptomyces sp. GS7	2692234	S	1382	655	2037	0.00032
Streptomyces sp. RLB1-33	2721243	S	1382	1570	2952	0.00046
Streptomyces sp. QHH-9511	2684468	S	1374	645	2019	0.00031
Streptomyces sp. Rer75	2750011	S	1372	1701	3073	0.00048
Streptomyces sp. RTd22	1841249	S	1343	1478	2821	0.00044
Streptomyces sp. NEAU-sy36	2751189	S	1320	839	2159	0.00033
Streptomyces sp. Go-475	2072505	S	1319	1000	2319	0.00036
Streptomyces sp. MBT27	1488356	S	1313	568	1881	0.00029
Streptomyces sp. C8S0	2585716	S	1275	590	1865	0.00029
Streptomyces sp. NA04227	2742136	S	1253	465	1718	0.00027
Streptomyces sp. CMB-StM0423	2059884	S	1249	1730	2979	0.00046
Streptomyces sp. JB150	2714844	S	1231	822	2053	0.00032
Streptomyces sp. DSM 40868	2721173	S	1224	744	1968	0.00031
Streptomyces sp. PBH53	1577075	S	1174	842	2016	0.00031
Streptomyces sp. RPA4-2	2721244	S	1158	645	1803	0.00028
Streptomyces sp. WAC 01529	2203205	S	1146	652	1798	0.00028
Streptomyces sp. HSG2	2797167	S	1125	395	1520	0.00024
Streptomyces sp. Z022	1442032	S	1089	656	1745	0.00027
Streptomyces sp. SM18	1736046	S	1051	569	1620	0.00025
Streptomyces sp. Tu 2975	2676871	S	1022	559	1581	0.00025
Streptomyces sp. SirexAA-E	862751	S	1015	584	1599	0.00025
Streptomyces sp. 2323.1	1938841	S	1011	517	1528	0.00024
Streptomyces sp. fd1-xmd	1812480	S	993	872	1865	0.00029
Streptomyces sp. INR7	2607753	S	942	1000	1942	0.00030
Streptomyces sp. SYP-A7193	2662065	S	942	960	1902	0.00029
Streptomyces sp. TN58	234612	S	882	824	1706	0.00026
Streptomyces sp. CB09001	2083284	S	793	899	1692	0.00026
Streptomyces sp. S4.7	2705439	S	792	457	1249	0.00019
Streptomyces sp. jing01	2726118	S	756	688	1444	0.00022
Streptomyces sp. WAC 06738	2203210	S	755	2067	2822	0.00044
Streptomyces sp. SUK 48	2582831	S	688	739	1427	0.00022
Streptomyces sp. 769	1262452	S	632	584	1216	0.00019
Streptomyces sp. CCM_MD2014	1561022	S	626	1055	1681	0.00026
Streptomyces sp. RPA4-5	2721245	S	616	551	1167	0.00018
Streptomyces sp. CNQ-509	444103	S	612	1568	2180	0.00034
Streptomyces sp. ADI95-16	1522758	S	606	1092	1698	0.00026
Streptomyces sp. HF10	2692233	S	590	699	1289	0.00020
Streptomyces sp. Mg1	465541	S	565	1092	1657	0.00026
Streptomyces sp. S063	2005885	S	542	562	1104	0.00017
Streptomyces sp. AgN23	1188315	S	484	607	1091	0.00017
Streptomyces sp. CB00271	2750025	S	478	607	1085	0.00017
Streptomyces sp. S8	1837283	S	474	573	1047	0.00016
Streptomyces sp. NA02536	2742133	S	462	1579	2041	0.00032
Streptomyces sp. Tue 6075	1661694	S	440	531	971	0.00015
Streptomyces sp. 3211	1964449	S	429	964	1393	0.00022
Streptomyces sp. NEAU-S7GS2	2202000	S	429	544	973	0.00015
Streptomyces sp. ID38640	1265399	S	373	487	860	0.00013
Streptomyces sp. MOE7	1961713	S	347	551	898	0.00014
Streptomyces sp. XC 2026	2782004	S	347	458	805	0.00012
Streptomyces sp. Sge12	1972846	S	341	1155	1496	0.00023
Streptomyces sp. 11-1-2	1851167	S	239	579	818	0.00013
Streptomyces sp. SGAir0924	2109593	S	234	1336	1570	0.00024
Streptomyces sp. CFMR 7	1649184	S	232	468	700	0.00011
Streptomyces sp. SS52	2563602	S	224	1508	1732	0.00027
Streptomyces sp. M56	1495638	S	208	712	920	0.00014
Streptomyces sp. CB04723	2748873	S	208	460	668	0.00010
Streptomyces sp. VN1	1821625	S	169	814	983	0.00015
Streptomyces sp. endophyte_N2	2153485	S	168	646	814	0.00013
Streptomyces sp. Tu6071	355249	S	161	1128	1289	0.00020
Streptomyces sp. CLI2509	1984801	S	154	1149	1303	0.00020
Streptomyces sp. NA03103	2742134	S	142	1268	1410	0.00022
Streptomyces sp. 604F	1476754	S	103	958	1061	0.00016
Streptomyces sp. 2114.2	1881022	S	100	702	802	0.00012
Streptomyces venezuelae	54571	S	7800	4026	11826	0.00183
Streptomyces bathyalis	2710756	S	6821	1874	8695	0.00135
Streptomyces chartreusis	1969	S	6022	3660	9682	0.00150
Streptomyces asterosporus	285570	S	3406	2228	5634	0.00087
Streptomyces griseus	1911	S	1410	1884	3294	0.00051
Streptomyces sp. M54	2759525	S	124	392	516	0.00008
Streptomyces globisporus	1908	S	1120	1475	2595	0.00040
Streptomyces anulatus	1892	S	565	666	1231	0.00019
Streptomyces cyaneochromogenes	2496836	S	3324	1554	4878	0.00076
Streptomyces nigra	1827580	S	3293	1904	5197	0.00081
Streptomyces albus	1888	S	3183	1253	4436	0.00069
Streptomyces capitiformicae	2014920	S	2992	995	3987	0.00062
Streptomyces pristinaespiralis	38300	S	2837	1838	4675	0.00072
Streptomyces armeniacus	83291	S	2726	908	3634	0.00056
Streptomyces griseorubiginosus	67304	S	2596	1270	3866	0.00060
Streptomyces bingchenggensis	379067	S	2587	873	3460	0.00054
Streptomyces lydicus	47763	S	2549	2062	4611	0.00071
Streptomyces seoulensis	73044	S	2360	1344	3704	0.00057
Streptomyces phaeolivaceus	2653200	S	2330	918	3248	0.00050
Streptomyces aquilus	2548456	S	2291	1065	3356	0.00052
Streptomyces buecherae	2763006	S	2256	873	3129	0.00049
Streptomyces ferrugineus	1413221	S	2252	1137	3389	0.00053
Streptomyces lunaelactis	1535768	S	2237	781	3018	0.00047
Streptomyces lincolnensis	1915	S	2175	1014	3189	0.00049
Streptomyces tsukubensis	83656	S	2157	733	2890	0.00045
Streptomyces niveus	193462	S	2092	1526	3618	0.00056
Streptomyces viridosporus	67581	S	2065	1448	3513	0.00054
Streptomyces tendae	1932	S	2056	1122	3178	0.00049
Streptomyces spectabilis	68270	S	1983	1051	3034	0.00047
Streptomyces cattleya	29303	S	1911	738	2649	0.00041
Streptomyces rimosus	1927	S	1843	2103	3946	0.00061
Streptomyces davaonensis	348043	S	1822	783	2605	0.00040
Streptomyces hygroscopicus	1912	S	1822	4763	6585	0.00102
Streptomyces cacaoi	1898	S	1802	853	2655	0.00041
Streptomyces cadmiisoli	2184053	S	1708	608	2316	0.00036
Streptomyces glomeroaurantiacus	68210	S	1670	618	2288	0.00035
Streptomyces xinghaiensis	1038928	S	1623	708	2331	0.00036
Streptomyces prasinus	67345	S	1604	818	2422	0.00038
Streptomyces dengpaensis	2049881	S	1581	628	2209	0.00034
Streptomyces rapamycinicus	1226757	S	1563	773	2336	0.00036
Streptomyces griseoviridis	45398	S	1551	745	2296	0.00036
Streptomyces peucetius	1950	S	1529	615	2144	0.00033
Streptomyces avermitilis	33903	S	1523	658	2181	0.00034
Streptomyces antibioticus	1890	S	1508	808	2316	0.00036
Streptomyces actuosus	1885	S	1494	907	2401	0.00037
Streptomyces qaidamensis	1783515	S	1479	962	2441	0.00038
Streptomyces vietnamensis	362257	S	1476	725	2201	0.00034
Streptomyces griseochromogenes	68214	S	1469	614	2083	0.00032
Streptomyces mobaraensis	35621	S	1459	636	2095	0.00032
Streptomyces alboflavus	67267	S	1437	611	2048	0.00032
Streptomyces albulus	68570	S	1435	655	2090	0.00032
Streptomyces paludis	2282738	S	1418	487	1905	0.00030
Streptomyces clavuligerus	1901	S	1414	430	1844	0.00029
Streptomyces olivoreticuli	68246	S	1392	550	1942	0.00030
Streptomyces globosus	68209	S	1385	662	2047	0.00032
Streptomyces harbinensis	1176198	S	1383	639	2022	0.00031
Streptomyces galilaeus	33899	S	1377	717	2094	0.00032
Streptomyces aureoverticillatus	66871	S	1376	606	1982	0.00031
Streptomyces luteoverticillatus	66425	S	1371	636	2007	0.00031
Streptomyces rectiverticillatus	173860	S	1362	609	1971	0.00031
Streptomyces albireticuli	1940	S	1358	612	1970	0.00031
Streptomyces parvulus	146923	S	1349	851	2200	0.00034
Streptomyces griseocarneus	51201	S	1345	644	1989	0.00031
Streptomyces nodosus	40318	S	1323	528	1851	0.00029
Streptomyces lavendulae	1914	S	1301	659	1960	0.00030
Streptomyces atratus	1893	S	1298	422	1720	0.00027
Streptomyces ficellus	1977088	S	1289	646	1935	0.00030
Streptomyces ambofaciens	1889	S	1278	1175	2453	0.00038
Streptomyces hawaiiensis	67305	S	1276	858	2134	0.00033
Streptomyces coeruleorubidus	116188	S	1257	856	2113	0.00033
Streptomyces broussonetiae	2686304	S	1240	572	1812	0.00028
Streptomyces chromofuscus	42881	S	1235	719	1954	0.00030
Streptomyces glaucescens	1907	S	1216	734	1950	0.00030
Streptomyces exfoliatus	1905	S	1208	613	1821	0.00028
Streptomyces fodineus	1904616	S	1200	650	1850	0.00029
Streptomyces collinus	42684	S	1174	647	1821	0.00028
Streptomyces tuirus	68278	S	1160	894	2054	0.00032
Streptomyces katrae	68223	S	1151	613	1764	0.00027
Streptomyces subrutilus	36818	S	1143	634	1777	0.00028
Streptomyces pactum	68249	S	1136	702	1838	0.00028
Streptomyces hundungensis	1077946	S	1123	469	1592	0.00025
Streptomyces roseochromogenus	285450	S	1114	522	1636	0.00025
Streptomyces gilvosporeus	553510	S	1108	463	1571	0.00024
Streptomyces vinaceus	1960	S	1101	581	1682	0.00026
Streptomyces incarnatus	665007	S	1095	622	1717	0.00027
Streptomyces formicae	1616117	S	1089	626	1715	0.00027
Streptomyces tirandamycinicus	2174846	S	1080	548	1628	0.00025
Streptomyces pratensis	1169025	S	1077	701	1778	0.00028
Streptomyces nitrosporeus	28894	S	1046	457	1503	0.00023
Streptomyces kanamyceticus	1967	S	1041	559	1600	0.00025
Streptomyces gardneri	66892	S	1018	631	1649	0.00026
Streptomyces fagopyri	2662397	S	1018	523	1541	0.00024
Streptomyces spongiicola	1690221	S	1002	481	1483	0.00023
Streptomyces qinzhouensis	2599401	S	993	376	1369	0.00021
Streptomyces cyanogenus	80860	S	979	606	1585	0.00025
Streptomyces alboniger	132473	S	977	534	1511	0.00023
Streptomyces rutgersensis	53451	S	970	632	1602	0.00025
Streptomyces finlayi	67296	S	965	331	1296	0.00020
Streptomyces pluripotens	1355015	S	937	329	1266	0.00020
Streptomyces nojiriensis	66374	S	876	557	1433	0.00022
Streptomyces olivaceus	47716	S	755	1708	2463	0.00038
Streptomyces albidoflavus	1886	S	488	2121	2609	0.00040
Streptomyces coelicolor	1902	S	126	875	1001	0.00016
Streptomyces leeuwenhoekii	1437453	S	665	636	1301	0.00020
Streptomyces cyaneogriseus	68192	S	607	674	1281	0.00020
Streptomyces violaceusniger	68280	S	601	494	1095	0.00017
Streptomyces koyangensis	188770	S	597	774	1371	0.00021
Streptomyces noursei	1971	S	512	519	1031	0.00016
Streptomyces platensis	58346	S	493	450	943	0.00015
Streptomyces fulvissimus	68202	S	485	2178	2663	0.00041
Streptomyces antimycoticus	68175	S	484	625	1109	0.00017
Streptomyces fungicidicus	68203	S	481	1641	2122	0.00033
Streptomyces viridifaciens	48665	S	413	1621	2034	0.00032
Streptomyces xiamenensis	408015	S	372	466	838	0.00013
Streptomyces cavourensis	67258	S	241	538	779	0.00012
Streptomyces californicus	67351	S	230	765	995	0.00015
Streptomyces alfalfae	1642299	S	199	1067	1266	0.00020
Streptomyces autolyticus	75293	S	186	825	1011	0.00016
Streptomyces solisilvae	1929477	S	162	619	781	0.00012
Streptomyces murinus	33900	S	146	519	665	0.00010
Streptomyces malaysiensis	92644	S	136	520	656	0.00010
Streptomyces scabiei	1930	S	127	1125	1252	0.00019
Streptomyces lividans	1916	S	117	32708	32825	0.00509
Streptomyces griseofuscus	146922	S	111	498	609	0.00009
Streptomyces fradiae	1906	S	102	158301	158403	0.02456
Kitasatospora sp. MMS16-BH015	2018025	S	2109	905	3014	0.00047
Kitasatospora sp. NA04385	2742135	S	1587	1120	2707	0.00042
Kitasatospora setae	2066	S	1684	1151	2835	0.00044
Kitasatospora albolonga	68173	S	646	599	1245	0.00019
Kitasatospora aureofaciens	1894	S	244	1134	1378	0.00021
Streptacidiphilus sp. P02-A3a	2704468	S	2020	853	2873	0.00045
Streptacidiphilus sp. PB12-B1b	2705012	S	1776	896	2672	0.00041
Streptacidiphilus bronchialis	2126346	S	1588	742	2330	0.00036
Microbacterium sp. WY121	2782168	S	2059	1036	3095	0.00048
Microbacterium sp. NY27	2782169	S	1971	968	2939	0.00046
Microbacterium sp. 4R-513	2567934	S	1491	632	2123	0.00033
Microbacterium sp. No. 7	1714373	S	1454	783	2237	0.00035
Microbacterium sp. 10M-3C3	2483401	S	1078	694	1772	0.00027
Microbacterium sp. JZ31	1906274	S	1053	567	1620	0.00025
Microbacterium sp. YJN-G	2763257	S	865	490	1355	0.00021
Microbacterium sp. ABRD_28	2268461	S	856	330	1186	0.00018
Microbacterium sp. BH-3-3-3	1906742	S	825	420	1245	0.00019
Microbacterium sp. A18JL200	2782167	S	773	415	1188	0.00018
Microbacterium sp. XT11	367477	S	772	386	1158	0.00018
Microbacterium sp. PM5	2014534	S	687	332	1019	0.00016
Microbacterium sp. RG1	2489212	S	663	270	933	0.00014
Microbacterium sp. A18JL241	2782166	S	633	300	933	0.00014
Microbacterium sp. Se63.02b	2709304	S	632	385	1017	0.00016
Microbacterium sp. LKL04	912630	S	629	340	969	0.00015
Microbacterium sp. Y-01	2048898	S	588	503	1091	0.00017
Microbacterium sp. TPU 3598	1938334	S	567	400	967	0.00015
Microbacterium sp. 1S1	2606451	S	508	700	1208	0.00019
Microbacterium sp. CBA3102	2603598	S	496	309	805	0.00012
Microbacterium sp. Nx66	2766784	S	444	1032	1476	0.00023
Microbacterium sp. HY82	2708079	S	344	63	407	0.00006
Microbacterium sp. HY60	2769067	S	294	45	339	0.00005
Microbacterium sp. PAMC 28756	1795053	S	281	978	1259	0.00020
Microbacterium sp. 1.5R	1916917	S	131	739	870	0.00013
Microbacterium sp. CGR1	1696072	S	122	712	834	0.00013
Microbacterium sp. SGAir0570	2070348	S	108	897	1005	0.00016
Microbacterium hominis	162426	S	2455	1460	3915	0.00061
Microbacterium foliorum	104336	S	1604	967	2571	0.00040
Microbacterium oleivorans	273677	S	1346	634	1980	0.00031
Microbacterium oxydans	82380	S	1036	761	1797	0.00028
Microbacterium lemovicicum	1072463	S	996	505	1501	0.00023
Microbacterium pygmaeum	370764	S	967	353	1320	0.00020
Microbacterium sediminis	904291	S	945	723	1668	0.00026
Microbacterium oryzae	743009	S	843	445	1288	0.00020
Microbacterium caowuchunii	2614638	S	824	341	1165	0.00018
Microbacterium testaceum	2033	S	819	363	1182	0.00018
Microbacterium aurum	36805	S	807	504	1311	0.00020
Microbacterium chocolatum	84292	S	805	367	1172	0.00018
Microbacterium wangchenii	2541726	S	768	481	1249	0.00019
Microbacterium protaetiae	2509458	S	723	250	973	0.00015
Microbacterium esteraromaticum	57043	S	721	350	1071	0.00017
Microbacterium lushaniae	2614639	S	685	443	1128	0.00017
Microbacterium schleiferi	69362	S	561	236	797	0.00012
Microbacterium hydrocarbonoxydans	273678	S	545	301	846	0.00013
Microbacterium amylolyticum	936337	S	317	74	391	0.00006
Microbacterium endophyticum	1526412	S	223	28	251	0.00004
Microbacterium paludicola	300019	S	104	970	1074	0.00017
Agromyces sp. LHK192	2498704	S	1741	1041	2782	0.00043
Agromyces sp. KACC 19306	2592652	S	1648	992	2640	0.00041
Agromyces sp. HY052	2585717	S	1232	681	1913	0.00030
Agromyces sp. G127AT	2781962	S	1131	624	1755	0.00027
Agromyces flavus	589382	S	4498	2672	7170	0.00111
Agromyces aureus	453304	S	2016	1149	3165	0.00049
Agromyces protaetiae	2509455	S	1392	773	2165	0.00034
Agromyces badenianii	2080742	S	1323	930	2253	0.00035
Rathayibacter sp. VKM Ac-2759	2609252	S	1039	603	1642	0.00025
Rathayibacter sp. VKM Ac-2760	2609253	S	806	600	1406	0.00022
Rathayibacter sp. VKM Ac-2804	2609257	S	655	713	1368	0.00021
Rathayibacter sp. VKM Ac-2801	2609255	S	389	551	940	0.00015
Rathayibacter sp. VKM Ac-2762	2609254	S	215	756	971	0.00015
Rathayibacter sp. VKM Ac-2805	2609258	S	146	519	665	0.00010
Rathayibacter festucae	110937	S	992	1581	2573	0.00040
Rathayibacter tanaceti	1671680	S	651	330	981	0.00015
Rathayibacter tritici	33888	S	397	230	627	0.00010
Rathayibacter rathayi	33887	S	377	205	582	0.00009
Rathayibacter iranicus	59737	S	376	107	483	0.00007
Rathayibacter toxicus	145458	S	178	22	200	0.00003
Curtobacterium sp. BH-2-1-1	1905847	S	713	488	1201	0.00019
Curtobacterium sp. SGAir0471	2070337	S	613	530	1143	0.00018
Curtobacterium sp. MR_MD2014	1561023	S	586	496	1082	0.00017
Curtobacterium sp. YC1	2795488	S	563	432	995	0.00015
Curtobacterium sp. 24E2	2804758	S	551	363	914	0.00014
Curtobacterium sp. Csp2	2495430	S	328	990	1318	0.00020
Curtobacterium flaccumfaciens	2035	S	1093	717	1810	0.00028
Curtobacterium pusillum	69373	S	641	295	936	0.00015
Leifsonia sp. PS1209	2724914	S	911	490	1401	0.00022
Leifsonia sp. 21MFCrub1.1	1798223	S	886	1540	2426	0.00038
Leifsonia xyli	1575	S	1751	1298	3049	0.00047
Leifsonia shinshuensis	150026	S	1332	652	1984	0.00031
Clavibacter michiganensis	28447	S	3129	2258	5387	0.00084
Clavibacter sp. DM1	2768071	S	554	574	1128	0.00017
Agrococcus carbonis	684552	S	1222	712	1934	0.00030
Agrococcus jejuensis	399736	S	1092	635	1727	0.00027
Agrococcus sp. SGAir0287	2070347	S	1038	612	1650	0.00026
Leucobacter muris	1935379	S	843	409	1252	0.00019
Leucobacter triazinivorans	1784719	S	792	375	1167	0.00018
Leucobacter sp. CX169	2813744	S	544	186	730	0.00011
Leucobacter insecticola	2714934	S	206	35	241	0.00004
Leucobacter viscericola	2714935	S	201	46	247	0.00004
Leucobacter coleopterorum	2714933	S	159	35	194	0.00003
Leucobacter denitrificans	683042	S	141	23	164	0.00003
Salinibacterium sp. ZJ450	2708338	S	791	280	1071	0.00017
Salinibacterium sp. ZJ70	2708084	S	655	349	1004	0.00016
Salinibacterium sp. dk2585	2603292	S	618	227	845	0.00013
Salinibacterium sp. UTAS2018	2508880	S	248	31	279	0.00004
Salinibacterium hongtaonis	2079791	S	286	58	344	0.00005
Protaetiibacter intestinalis	2419774	S	1026	706	1732	0.00027
Protaetiibacter sp. SSC-01	2759943	S	1009	661	1670	0.00026
Cryobacterium sp. LW097	1978566	S	558	228	786	0.00012
Cryobacterium arcticum	670052	S	536	415	951	0.00015
Cryobacterium soli	2220095	S	505	380	885	0.00014
Frondihabitans sp. PAMC 28766	1795630	S	899	255	1154	0.00018
Frondihabitans sp. 762G35	1446794	S	784	331	1115	0.00017
Microterricola viridarii	412690	S	1680	798	2478	0.00038
Plantibacter sp. PA-3-X8	2480625	S	283	398	681	0.00011
Plantibacter sp. M259	2583822	S	282	386	668	0.00010
Plantibacter flavus	150123	S	370	440	810	0.00013
Humibacter sp. WJ7-1	2599293	S	963	330	1293	0.00020
Humibacter sp. BT305	2282656	S	262	1221	1483	0.00023
Frigoribacterium sp. NBH87	2596916	S	1154	613	1767	0.00027
Herbiconiux sp. SALV-R1	2735133	S	1148	444	1592	0.00025
Chryseoglobus sp. 28M-23	2772253	S	233	637	870	0.00014
Chryseoglobus indicus	2750620	S	168	458	626	0.00010
Gryllotalpicola protaetiae	2419771	S	1018	381	1399	0.00022
Mycetocola zhujimingii	2079792	S	441	108	549	0.00009
Mycetocola sp. JXN-3	2116510	S	420	104	524	0.00008
Marisediminicola antarctica	674079	S	729	227	956	0.00015
Lysinimonas sp. KACC 19322	2592654	S	729	461	1190	0.00018
Microcella alkaliphila	279828	S	666	246	912	0.00014
Diaminobutyricimonas sp. LJ205	2683590	S	596	227	823	0.00013
Glaciihabitans sp. INWT7	2596912	S	572	131	703	0.00011
Agreia sp. COWG	2773266	S	492	138	630	0.00010
Cnuibacter physcomitrellae	1619308	S	430	1540	1970	0.00031
Arthrobacter sp. QXT-31	1357915	S	2776	974	3750	0.00058
Arthrobacter sp. NEB 688	904039	S	1888	1399	3287	0.00051
Arthrobacter sp. 24S4-2	2575374	S	716	255	971	0.00015
Arthrobacter sp. PM3	2017685	S	715	308	1023	0.00016
Arthrobacter sp. PAMC25564	2565366	S	622	273	895	0.00014
Arthrobacter sp. U41	1849032	S	610	259	869	0.00013
Arthrobacter sp. PGP41	2079227	S	579	212	791	0.00012
Arthrobacter sp. FB24	290399	S	564	243	807	0.00013
Arthrobacter sp. UKPF54-2	2600159	S	552	440	992	0.00015
Arthrobacter sp. KBS0702	2578107	S	545	392	937	0.00015
Arthrobacter sp. ERGS1:01	1704044	S	483	146	629	0.00010
Arthrobacter sp. YC-RL1	1652545	S	299	164	463	0.00007
Arthrobacter sp. PAMC 25486	1494608	S	294	70	364	0.00006
Arthrobacter sp. YN	2020486	S	238	198	436	0.00007
Arthrobacter sp. D5-1	1477518	S	204	197	401	0.00006
Arthrobacter agilis	37921	S	1449	454	1903	0.00030
Arthrobacter crystallopoietes	37928	S	1042	280	1322	0.00021
Arthrobacter dokdonellae	2211210	S	579	165	744	0.00012
Arthrobacter woluwensis	156980	S	563	190	753	0.00012
Arthrobacter alpinus	656366	S	443	538	981	0.00015
Kocuria rosea	1275	S	1914	1168	3082	0.00048
Kocuria turfanensis	388357	S	1147	703	1850	0.00029
Kocuria flava	446860	S	1136	735	1871	0.00029
Kocuria sp. TGY1120_3	2711329	S	294	62	356	0.00006
Kocuria sp. TGY1127_2	2711328	S	173	30	203	0.00003
Kocuria palustris	71999	S	598	266	864	0.00013
Kocuria varians	1272	S	393	294	687	0.00011
Kocuria rhizophila	72000	S	343	998	1341	0.00021
Pseudarthrobacter sp. BIM B-2242	2772401	S	471	139	610	0.00009
Pseudarthrobacter sp. YJ56	2697569	S	385	206	591	0.00009
Pseudarthrobacter sp. NIBRBAC000502772	2590775	S	323	304	627	0.00010
Pseudarthrobacter sp. NBSH8	2596911	S	301	168	469	0.00007
Pseudarthrobacter sp. NIBRBAC000502770	2590785	S	172	405	577	0.00009
Pseudarthrobacter sp. NIBRBAC000502771	2590774	S	130	325	455	0.00007
Pseudarthrobacter phenanthrenivorans	361575	S	555	248	803	0.00012
Pseudarthrobacter chlorophenolicus	85085	S	465	214	679	0.00011
Pseudarthrobacter equi	728066	S	373	211	584	0.00009
Pseudarthrobacter sulfonivorans	121292	S	267	246	513	0.00008
Sinomonas atrocyanea	37927	S	1528	629	2157	0.00033
Sinomonas sp. R1AF57	2020377	S	1067	404	1471	0.00023
Micrococcus luteus	1270	S	1396	3194	4590	0.00071
Glutamicibacter creatinolyticus	162496	S	443	148	591	0.00009
Glutamicibacter protophormiae	37930	S	305	219	524	0.00008
Glutamicibacter halophytocola	1933880	S	224	58	282	0.00004
Glutamicibacter mishrai	1775880	S	204	63	267	0.00004
Glutamicibacter arilaitensis	256701	S	164	56	220	0.00003
Glutamicibacter nicotianae	37929	S	112	353	465	0.00007
Rothia kristinae	37923	S	836	456	1292	0.00020
Rothia mucilaginosa	43675	S	276	71	347	0.00005
Rothia nasimurium	85336	S	109	29	138	0.00002
Paenarthrobacter sp. YJN-D	2735317	S	306	124	430	0.00007
Paenarthrobacter sp. YJN-5	2735316	S	266	666	932	0.00014
Paenarthrobacter ureafaciens	37931	S	421	2380	2801	0.00043
Paenarthrobacter aurescens	43663	S	122	520	642	0.00010
Citricoccus sp. SGAir0253	2567881	S	1025	451	1476	0.00023
Nesterenkonia sp. NBAIMH1	2600320	S	424	74	498	0.00008
Zhihengliuella sp. ISTPL4	2058657	S	337	949	1286	0.00020
Psychromicrobium lacuslunae	1618207	S	227	21	248	0.00004
Neomicrococcus aestuarii	556325	S	142	26	168	0.00003
Auritidibacter sp. NML130574	2170745	S	110	14	124	0.00002
Renibacterium salmoninarum	1646	S	106	8	114	0.00002
Isoptericola dokdonensis	372663	S	6789	4059	10848	0.00168
Isoptericola variabilis	139208	S	1788	1360	3148	0.00049
Cellulosimicrobium sp. BI34T	2587808	S	1438	1045	2483	0.00039
Cellulosimicrobium sp. JZ28	1906273	S	365	1148	1513	0.00023
Cellulosimicrobium sp. 72-3	2731680	S	125	843	968	0.00015
Cellulosimicrobium sp. TH-20	1980001	S	109	752	861	0.00013
Cellulosimicrobium cellulans	1710	S	1547	2681	4228	0.00066
Xylanimonas cellulosilytica	186189	S	1320	776	2096	0.00032
Xylanimonas allomyrinae	2509459	S	1222	651	1873	0.00029
Xylanimicrobium sp. FW10M-9	2509457	S	1536	1072	2608	0.00040
Cellulomonas sp. H30R-01	2704467	S	2122	1381	3503	0.00054
Cellulomonas sp. Y8	2591145	S	1794	1122	2916	0.00045
Cellulomonas sp. JZ18	2654191	S	1470	987	2457	0.00038
Cellulomonas sp. PSBB021	2003551	S	1283	915	2198	0.00034
Cellulomonas fimi	1708	S	1679	2116	3795	0.00059
Cellulomonas flavigena	1711	S	1336	738	2074	0.00032
Cellulomonas shaoxiangyii	2566013	S	1281	847	2128	0.00033
Cellulomonas gilvus	11	S	1180	730	1910	0.00030
Cellulomonas taurus	2729175	S	926	475	1401	0.00022
Actinotalea sp. JY-7876	2758442	S	1464	864	2328	0.00036
Oerskovia sp. KBS0722	1179673	S	1244	644	1888	0.00029
Pseudactinotalea sp. HY158	2654547	S	1062	350	1412	0.00022
Paraoerskovia marina	545619	S	782	365	1147	0.00018
Janibacter melonis	262209	S	1450	818	2268	0.00035
Janibacter limosus	53458	S	1007	510	1517	0.00024
Janibacter indicus	857417	S	571	1141	1712	0.00027
Janibacter sp. YB324	2761047	S	335	906	1241	0.00019
Phycicoccus sp. HDW14	2714941	S	1768	1248	3016	0.00047
Phycicoccus endophyticus	1690220	S	1596	1012	2608	0.00040
Intrasporangium calvum	53358	S	3001	1780	4781	0.00074
Pedococcus dokdonensis	443156	S	1875	1027	2902	0.00045
Tetrasphaera sp. HKS02	1813880	S	1393	701	2094	0.00032
Arsenicicoccus sp. oral taxon 190	1658671	S	1390	782	2172	0.00034
Ornithinimicrobium sp. AMA3305	2283195	S	1540	737	2277	0.00035
Ornithinimicrobium sp. HY006	2508882	S	1027	569	1596	0.00025
Ornithinimicrobium sp. H23M54	2594265	S	970	305	1275	0.00020
Ornithinimicrobium flavum	1288636	S	1244	636	1880	0.00029
Ornithinimicrobium pratense	2593973	S	807	425	1232	0.00019
Serinicoccus chungangensis	767452	S	1195	688	1883	0.00029
Serinicoccus profundi	1078471	S	1052	573	1625	0.00025
Serinicoccus marinus	247333	S	958	673	1631	0.00025
Serinicoccus hydrothermalis	1758689	S	958	659	1617	0.00025
Brevibacterium sp. CS2	2575923	S	948	450	1398	0.00022
Brevibacterium sp. PAMC23299	2762330	S	559	6098	6657	0.00103
Brevibacterium sp. WO024	2697563	S	327	161	488	0.00008
Brevibacterium sp. o2	2697565	S	291	183	474	0.00007
Brevibacterium sp. 'Marine'	2725563	S	217	230	447	0.00007
Brevibacterium sp. YB235	1496080	S	154	166	320	0.00005
Brevibacterium casei	33889	S	1820	706	2526	0.00039
Brevibacterium linens	1703	S	576	515	1091	0.00017
Brevibacterium luteolum	199591	S	574	230	804	0.00012
Brevibacterium aurantiacum	273384	S	472	192	664	0.00010
Brevibacterium sandarakinum	629680	S	415	120	535	0.00008
Brevibacterium oceani	358099	S	343	173	516	0.00008
Brevibacterium siliguriense	1136497	S	215	134	349	0.00005
Brachybacterium sp. P6-10-X1	1903186	S	961	329	1290	0.00020
Brachybacterium sp. SGAir0954	2571029	S	928	434	1362	0.00021
Brachybacterium saurashtrense	556288	S	849	439	1288	0.00020
Brachybacterium ginsengisoli	1331682	S	807	385	1192	0.00018
Brachybacterium faecium	43669	S	795	419	1214	0.00019
Brachybacterium vulturis	2017484	S	681	401	1082	0.00017
Brachybacterium avium	2017485	S	579	323	902	0.00014
Dermabacter vaginalis	1630135	S	281	125	406	0.00006
Dermabacter jinjuensis	1667168	S	272	131	403	0.00006
Devriesea agamarum	472569	S	124	11	135	0.00002
Georgenia sp. Z443	2589797	S	1650	698	2348	0.00036
Georgenia sp. Z294	2585135	S	1335	718	2053	0.00032
Georgenia faecalis	2483799	S	1323	659	1982	0.00031
Dermacoccus nishinomiyaensis	1274	S	911	476	1387	0.00022
Dermacoccus sp. PAMC28757	2762331	S	726	367	1093	0.00017
Luteipulveratus mongoliensis	571913	S	1271	357	1628	0.00025
Yimella sp. cx-51	2770551	S	728	262	990	0.00015
Beutenbergia cavernae	84757	S	2101	758	2859	0.00044
Miniimonas sp. S16	2171623	S	1338	803	2141	0.00033
Haloactinobacterium sp. HY164	2675754	S	1640	501	2141	0.00033
Ruania sp. HY168	2603206	S	928	221	1149	0.00018
Haloactinobacterium sp. RN3S43	2779775	S	783	181	964	0.00015
Sanguibacter keddieii	60920	S	1175	559	1734	0.00027
Sanguibacter sp. HDW7	2714931	S	941	459	1400	0.00022
Luteimicrobium xylanilyticum	1133546	S	1533	747	2280	0.00035
Mobilicoccus sp. NJES-13	2716227	S	616	145	761	0.00012
Austwickia chelonae	100225	S	415	67	482	0.00007
Dermatophilus congolensis	1863	S	102	11	113	0.00002
Kytococcus sedentarius	1276	S	1000	481	1481	0.00023
Mycolicibacterium thermoresistibile	1797	S	4172	1938	6110	0.00095
Mycolicibacterium aurum	1791	S	1990	900	2890	0.00045
Mycolicibacterium litorale	758802	S	1989	1225	3214	0.00050
Mycolicibacterium sp. LJ126	2761578	S	927	443	1370	0.00021
Mycolicibacterium sp. Z-34	2736649	S	738	215	953	0.00015
Mycolicibacterium smegmatis	1772	S	1440	1085	2525	0.00039
Mycolicibacterium pulveris	36813	S	1411	574	1985	0.00031
Mycolicibacterium rhodesiae	36814	S	1407	519	1926	0.00030
Mycolicibacterium hassiacum	46351	S	1379	778	2157	0.00033
Mycolicibacterium rutilum	370526	S	1349	784	2133	0.00033
Mycolicibacterium frederiksbergense	117567	S	1330	716	2046	0.00032
Mycolicibacterium phlei	1771	S	1299	872	2171	0.00034
Mycolicibacterium madagascariense	212765	S	1296	501	1797	0.00028
Mycolicibacterium arabiense	1286181	S	1278	477	1755	0.00027
Mycolicibacterium mageritense	53462	S	1262	463	1725	0.00027
Mycolicibacterium moriokaense	39691	S	1252	424	1676	0.00026
Mycolicibacterium chubuense	1800	S	1250	569	1819	0.00028
Mycolicibacterium sediminis	1286180	S	1240	561	1801	0.00028
Mycolicibacterium psychrotolerans	216929	S	1203	571	1774	0.00028
Mycolicibacterium chitae	1792	S	1185	591	1776	0.00028
Mycolicibacterium gilvum	1804	S	1180	819	1999	0.00031
Mycolicibacterium vaccae	1810	S	1130	572	1702	0.00026
Mycolicibacterium parafortuitum	39692	S	1103	557	1660	0.00026
Mycolicibacterium goodii	134601	S	1053	557	1610	0.00025
Mycolicibacterium celeriflavum	1249101	S	1039	442	1481	0.00023
Mycolicibacterium tokaiense	39695	S	1010	374	1384	0.00021
Mycolicibacterium boenickei	146017	S	992	1991	2983	0.00046
Mycolicibacterium duvalii	39688	S	983	428	1411	0.00022
Mycolicibacterium fluoranthenivorans	258505	S	979	327	1306	0.00020
Mycolicibacterium confluentis	28047	S	935	346	1281	0.00020
Mycolicibacterium fallax	1793	S	924	604	1528	0.00024
Mycolicibacterium gadium	1794	S	855	559	1414	0.00022
Mycolicibacterium insubricum	444597	S	785	379	1164	0.00018
Mycolicibacterium helvum	1534349	S	751	263	1014	0.00016
Mycolicibacterium mucogenicum	56689	S	730	513	1243	0.00019
Mycolicibacterium anyangense	1431246	S	729	286	1015	0.00016
Mycolicibacterium phocaicum	319706	S	689	486	1175	0.00018
Mycolicibacterium doricum	126673	S	677	375	1052	0.00016
Mycolicibacterium aubagnense	319707	S	629	291	920	0.00014
Mycolicibacterium fortuitum	1766	S	627	304	931	0.00014
Mycolicibacterium alvei	67081	S	626	324	950	0.00015
Mycolicibacterium aichiense	1799	S	552	385	937	0.00015
Mycolicibacterium sarraceniae	1534348	S	492	192	684	0.00011
Mycolicibacterium poriferae	39694	S	282	895	1177	0.00018
Mycolicibacterium vanbaalenii	110539	S	204	1206	1410	0.00022
Mycolicibacterium austroafricanum	39687	S	196	1216	1412	0.00022
Mycolicibacterium monacense	85693	S	185	1086	1271	0.00020
Mycolicibacterium nivoides	2487344	S	154	1141	1295	0.00020
Mycobacterium sp. JS623	212767	S	2744	557	3301	0.00051
Mycobacterium sp. DL592	2675524	S	819	323	1142	0.00018
Mycobacterium sp. YC-RL4	1682113	S	805	404	1209	0.00019
Mycobacterium sp. EPa45	1545728	S	791	314	1105	0.00017
Mycobacterium sp. MS1601	1936029	S	779	246	1025	0.00016
Mycobacterium sp. ELW1	1547487	S	634	407	1041	0.00016
Mycobacterium sp. DL440	2675523	S	619	293	912	0.00014
Mycobacterium sp. THAF192	2587868	S	213	568	781	0.00012
Mycobacterium sp. WY10	1920667	S	159	597	756	0.00012
Mycobacterium sp. PYR15	2051552	S	135	500	635	0.00010
Mycobacterium sp. KMS	189918	S	131	696	827	0.00013
Mycobacterium saskatchewanense	220927	S	961	305	1266	0.00020
Mycobacterium parmense	185642	S	880	339	1219	0.00019
Mycobacterium kubicae	120959	S	869	253	1122	0.00017
Mycobacterium heidelbergense	53376	S	748	322	1070	0.00017
Mycobacterium stomatepiae	470076	S	681	271	952	0.00015
Mycobacterium shigaense	722731	S	662	222	884	0.00014
Mycobacterium simiae	1784	S	656	164	820	0.00013
Mycobacterium florentinum	292462	S	653	270	923	0.00014
Mycobacterium avium	1764	S	1355	3041	4396	0.00068
Mycobacterium colombiense	339268	S	753	298	1051	0.00016
Mycobacterium intracellulare	1767	S	639	5514	6153	0.00095
Mycobacterium mantenii	560555	S	618	193	811	0.00013
Mycobacterium marseillense	701042	S	541	262	803	0.00012
Mycobacterium paraintracellulare	1138383	S	174	1314	1488	0.00023
Mycobacterium gordonae	1778	S	1393	264	1657	0.00026
Mycobacterium grossiae	1552759	S	1321	724	2045	0.00032
Mycobacterium dioxanotrophicus	482462	S	1144	393	1537	0.00024
Mycobacterium canettii	78331	S	294	380	674	0.00010
Mycobacterium tuberculosis	1773	S	222	29198	29420	0.00456
Mycobacterium gallinarum	39689	S	960	578	1538	0.00024
Mycobacterium branderi	43348	S	960	242	1202	0.00019
Mycobacterium paragordonae	1389713	S	863	209	1072	0.00017
Mycobacterium conspicuum	44010	S	846	294	1140	0.00018
Mycobacterium kansasii	1768	S	809	166	975	0.00015
Mycobacterium cookii	1775	S	740	187	927	0.00014
Mycobacterium riyadhense	486698	S	690	109	799	0.00012
Mycobacterium lacus	169765	S	666	166	832	0.00013
Mycobacterium heckeshornense	110505	S	639	157	796	0.00012
Mycobacterium shinjukuense	398694	S	622	179	801	0.00012
Mycobacterium haemophilum	29311	S	610	107	717	0.00011
Mycobacterium noviomagense	459858	S	608	149	757	0.00012
Mycobacterium paraseoulense	590652	S	596	276	872	0.00014
Mycobacterium xenopi	1789	S	562	159	721	0.00011
Mycobacterium seoulense	386911	S	530	284	814	0.00013
Mycobacterium basiliense	2094119	S	465	63	528	0.00008
Mycobacterium leprae	1769	S	141	328	469	0.00007
Mycobacterium marinum	1781	S	133	550	683	0.00011
Mycobacteroides abscessus	36809	S	952	1550	2502	0.00039
Mycobacteroides saopaulense	1578165	S	378	118	496	0.00008
Mycobacteroides chelonae	1774	S	371	871	1242	0.00019
Mycobacteroides immunogenum	83262	S	361	107	468	0.00007
Mycobacteroides salmoniphilum	404941	S	329	96	425	0.00007
[Mycobacterium] stephanolepidis	1520670	S	195	141	336	0.00005
Mycolicibacter terrae	1788	S	665	329	994	0.00015
Mycolicibacter hiberniae	29314	S	624	259	883	0.00014
Mycolicibacter minnesotensis	1118379	S	493	165	658	0.00010
Mycolicibacillus koreensis	1069220	S	740	317	1057	0.00016
Hoyosella subflava	639313	S	419	41	460	0.00007
Rhodococcus sp. X156	2499145	S	1373	794	2167	0.00034
Rhodococcus sp. MTM3W5.2	1805827	S	1246	522	1768	0.00027
Rhodococcus sp. SGAir0479	2567884	S	975	479	1454	0.00023
Rhodococcus sp. W8901	2742603	S	965	423	1388	0.00022
Rhodococcus sp. R79	2811421	S	867	588	1455	0.00023
Rhodococcus sp. PBTS 1	1653478	S	817	331	1148	0.00018
Rhodococcus sp. ABRD24	2507582	S	621	200	821	0.00013
Rhodococcus sp. WAY2	2663121	S	542	596	1138	0.00018
Rhodococcus sp. B7740	1564114	S	516	156	672	0.00010
Rhodococcus sp. P1Y	1302308	S	472	80	552	0.00009
Rhodococcus sp. WMMA185	679318	S	413	87	500	0.00008
Rhodococcus sp. WB9	2594007	S	238	621	859	0.00013
Rhodococcus sp. ZPP	2749906	S	217	750	967	0.00015
Rhodococcus sp. P-2	2795031	S	217	138	355	0.00006
Rhodococcus sp. DMU1	2722825	S	176	615	791	0.00012
Rhodococcus sp. PBTS 2	1653479	S	174	205	379	0.00006
Rhodococcus sp. S2-17	1990687	S	164	455	619	0.00010
Rhodococcus sp. M8	1925550	S	144	730	874	0.00014
Rhodococcus opacus	37919	S	2223	3195	5418	0.00084
Rhodococcus ruber	1830	S	1661	1063	2724	0.00042
Rhodococcus hoagii	43767	S	1343	940	2283	0.00035
Rhodococcus rhodochrous	1829	S	1136	943	2079	0.00032
Rhodococcus koreensis	99653	S	924	587	1511	0.00023
Rhodococcus fascians	1828	S	844	308	1152	0.00018
Rhodococcus triatomae	300028	S	805	302	1107	0.00017
Rhodococcus jostii	132919	S	701	602	1303	0.00020
Rhodococcus coprophilus	38310	S	659	203	862	0.00013
Rhodococcus pyridinivorans	103816	S	323	1440	1763	0.00027
Rhodococcus erythropolis	1833	S	192	1287	1479	0.00023
Rhodococcus qingshengii	334542	S	183	1128	1311	0.00020
Rhodococcus imtechensis	262776	S	138	630	768	0.00012
Rhodococcus aetherivorans	191292	S	102	1774	1876	0.00029
Nocardia brasiliensis	37326	S	3264	1530	4794	0.00074
Nocardia sp. CS682	1047172	S	1315	489	1804	0.00028
Nocardia sp. WCH-YHL-001	2755382	S	1305	433	1738	0.00027
Nocardia terpenica	455432	S	2276	754	3030	0.00047
Nocardia cyriacigeorgica	135487	S	2228	1339	3567	0.00055
Nocardia farcinica	37329	S	1798	1466	3264	0.00051
Nocardia asteroides	1824	S	1453	801	2254	0.00035
Nocardia arthritidis	228602	S	1429	366	1795	0.00028
Nocardia wallacei	480035	S	1397	523	1920	0.00030
Nocardia seriolae	37332	S	1220	513	1733	0.00027
Nocardia yunnanensis	2382165	S	1218	513	1731	0.00027
Nocardia otitidiscaviarum	1823	S	1192	439	1631	0.00025
Nocardia nova	37330	S	1155	324	1479	0.00023
Nocardia mangyaensis	2213200	S	1116	448	1564	0.00024
Corynebacterium sp. 2019	2675218	S	318	189	507	0.00008
Corynebacterium sp. zg-917	2763010	S	235	113	348	0.00005
Corynebacterium sp. MC1420	2709392	S	213	109	322	0.00005
Corynebacterium sp. zg-320	2768834	S	192	47	239	0.00004
Corynebacterium sp. Marseille-Q3630	2754725	S	188	67	255	0.00004
Corynebacterium sp. 2039	2675219	S	186	53	239	0.00004
Corynebacterium sp. NML98-0116	702967	S	149	48	197	0.00003
Corynebacterium sp. 1959	2675216	S	117	41	158	0.00002
Corynebacterium sphenisci	191493	S	813	429	1242	0.00019
Corynebacterium xerosis	1725	S	796	429	1225	0.00019
Corynebacterium frankenforstense	1230998	S	683	364	1047	0.00016
Corynebacterium bovis	36808	S	658	246	904	0.00014
Corynebacterium nuruki	1032851	S	558	225	783	0.00012
Corynebacterium halotolerans	225326	S	519	235	754	0.00012
Corynebacterium vitaeruminis	38305	S	430	196	626	0.00010
Corynebacterium maris	575200	S	429	145	574	0.00009
Corynebacterium variabile	1727	S	424	225	649	0.00010
Corynebacterium humireducens	1223514	S	392	214	606	0.00009
Corynebacterium liangguodongii	2079535	S	354	133	487	0.00008
Corynebacterium uterequi	1072256	S	350	195	545	0.00008
Corynebacterium yudongzhengii	2080740	S	348	130	478	0.00007
Corynebacterium marinum	349751	S	347	261	608	0.00009
Corynebacterium doosanense	1121358	S	338	156	494	0.00008
Corynebacterium terpenotabidum	89154	S	328	130	458	0.00007
Corynebacterium timonense	441500	S	316	123	439	0.00007
Corynebacterium mycetoides	38302	S	308	206	514	0.00008
Corynebacterium atypicum	191610	S	306	111	417	0.00006
Corynebacterium provencense	1737425	S	289	99	388	0.00006
Corynebacterium glyciniphilum	1404244	S	283	54	337	0.00005
Corynebacterium sanguinis	2594913	S	280	201	481	0.00007
Corynebacterium imitans	156978	S	280	112	392	0.00006
Corynebacterium jeikeium	38289	S	277	705	982	0.00015
Corynebacterium urealyticum	43771	S	251	130	381	0.00006
Corynebacterium efficiens	152794	S	223	65	288	0.00004
Corynebacterium ureicelerivorans	401472	S	221	91	312	0.00005
Corynebacterium glaucum	187491	S	212	64	276	0.00004
Corynebacterium aurimucosum	169292	S	205	117	322	0.00005
Corynebacterium lactis	1231000	S	203	46	249	0.00004
Corynebacterium kroppenstedtii	161879	S	188	18	206	0.00003
Corynebacterium striatum	43770	S	178	147	325	0.00005
Corynebacterium testudinoris	136857	S	177	50	227	0.00004
Corynebacterium glucuronolyticum	39791	S	175	33	208	0.00003
Corynebacterium genitalium	38288	S	164	47	211	0.00003
Corynebacterium tuberculostearicum	38304	S	160	105	265	0.00004
Corynebacterium aquilae	203263	S	155	31	186	0.00003
Corynebacterium simulans	146827	S	146	143	289	0.00004
Corynebacterium riegelii	156976	S	146	41	187	0.00003
Corynebacterium matruchotii	43768	S	142	12	154	0.00002
Corynebacterium endometrii	2488819	S	135	30	165	0.00003
Corynebacterium flavescens	28028	S	131	32	163	0.00003
Corynebacterium epidermidicanis	1050174	S	113	20	133	0.00002
Corynebacterium renale	1724	S	106	16	122	0.00002
Corynebacterium camporealensis	161896	S	105	33	138	0.00002
Corynebacterium stationis	1705	S	102	34	136	0.00002
Gordonia sp. YC-JH1	2059875	S	697	367	1064	0.00017
Gordonia sp. KTR9	337191	S	685	273	958	0.00015
Gordonia sp. PDNC005	2811424	S	596	150	746	0.00012
Gordonia sp. HY186	2597659	S	543	171	714	0.00011
Gordonia sp. JH63	2698900	S	245	513	758	0.00012
Gordonia sp. 135	2676309	S	164	490	654	0.00010
Gordonia sp. 1D	1737359	S	138	537	675	0.00010
Gordonia polyisoprenivorans	84595	S	1341	537	1878	0.00029
Gordonia insulae	2420509	S	1156	340	1496	0.00023
Gordonia terrae	2055	S	927	695	1622	0.00025
Gordonia phthalatica	1136941	S	818	364	1182	0.00018
Gordonia bronchialis	2054	S	737	240	977	0.00015
Gordonia iterans	1004901	S	713	289	1002	0.00016
Gordonia rubripertincta	36822	S	650	512	1162	0.00018
Gordonia alkanivorans	84096	S	159	526	685	0.00011
Gordonia ajococcus	1292359	S	122	550	672	0.00010
Dietzia sp. oral taxon 368	712270	S	537	1094	1631	0.00025
Dietzia psychralcaliphila	139021	S	677	286	963	0.00015
Dietzia lutea	546160	S	619	492	1111	0.00017
Dietzia timorensis	499555	S	471	169	640	0.00010
Tsukamurella paurometabola	2061	S	1622	1125	2747	0.00043
Tsukamurella tyrosinosolvens	57704	S	1378	761	2139	0.00033
Tomitella sp. HY172	2760083	S	978	470	1448	0.00022
Tomitella sp. HY188	2597660	S	856	422	1278	0.00020
Segniliparus rotundus	286802	S	539	90	629	0.00010
Micromonospora sp. WMMC415	2675222	S	3437	2700	6137	0.00095
Micromonospora sp. 28ISP2-46	2749844	S	1924	2215	4139	0.00064
Micromonospora sp. HM134	2583243	S	1755	1567	3322	0.00052
Micromonospora sp. WMMA2032	2039870	S	1581	1988	3569	0.00055
Micromonospora sp. B006	2201999	S	1408	2027	3435	0.00053
Micromonospora sp. L5	648999	S	151	1757	1908	0.00030
Micromonospora purpureochromogenes	47872	S	7082	6916	13998	0.00217
Micromonospora inositola	47865	S	3464	3200	6664	0.00103
Micromonospora echinaurantiaca	47857	S	2986	2766	5752	0.00089
Micromonospora terminaliae	1914461	S	2736	2724	5460	0.00085
Micromonospora carbonacea	47853	S	2588	2178	4766	0.00074
Micromonospora viridifaciens	1881	S	2575	2168	4743	0.00074
Micromonospora krabiensis	307121	S	2542	1803	4345	0.00067
Micromonospora echinofusca	47858	S	2397	2063	4460	0.00069
Micromonospora coxensis	356852	S	2292	2320	4612	0.00072
Micromonospora echinospora	1877	S	2229	1638	3867	0.00060
Micromonospora siamensis	299152	S	2161	1934	4095	0.00063
Micromonospora coriariae	285665	S	2103	1664	3767	0.00058
Micromonospora auratinigra	261654	S	2049	2045	4094	0.00063
Micromonospora maris	1003110	S	2013	1231	3244	0.00050
Micromonospora narathiwatensis	299146	S	1957	1818	3775	0.00059
Micromonospora sagamiensis	47875	S	1923	1560	3483	0.00054
Micromonospora chokoriensis	356851	S	1856	1354	3210	0.00050
Micromonospora zamorensis	709883	S	1642	1267	2909	0.00045
Micromonospora rifamycinica	291594	S	1624	1484	3108	0.00048
Micromonospora craniellae	2294034	S	1324	1430	2754	0.00043
Micromonospora tulbaghiae	479978	S	1011	1848	2859	0.00044
Micromonospora aurantiaca	47850	S	581	6301	6882	0.00107
Actinoplanes sp. N902-109	649831	S	4400	3436	7836	0.00121
Actinoplanes sp. OR16	946334	S	4014	4805	8819	0.00137
Actinoplanes friuliensis	196914	S	4718	1817	6535	0.00101
Actinoplanes derwentensis	113562	S	4152	1483	5635	0.00087
Actinoplanes teichomyceticus	1867	S	3923	2685	6608	0.00102
Actinoplanes missouriensis	1866	S	3736	2491	6227	0.00097
Phytohabitans suffuscus	624315	S	5758	3062	8820	0.00137
Phytohabitans flavus	1076124	S	4695	2162	6857	0.00106
Plantactinospora sp. KBS50	2024580	S	3018	1591	4609	0.00071
Plantactinospora sp. BB1	2071627	S	665	3018	3683	0.00057
Plantactinospora sp. BC1	2108470	S	587	2710	3297	0.00051
Actinocatenispora thailandica	227318	S	3634	1287	4921	0.00076
Salinispora arenicola	168697	S	1258	632	1890	0.00029
Salinispora tropica	168695	S	1165	620	1785	0.00028
Verrucosispora sp. NA02020	2742132	S	1610	1948	3558	0.00055
Pseudonocardia sp. CGMCC 4.1532	2761535	S	5727	4070	9797	0.00152
Pseudonocardia sp. HH130630-07	1690815	S	4209	3971	8180	0.00127
Pseudonocardia sp. AL041005-10	445576	S	3497	4288	7785	0.00121
Pseudonocardia sp. HH130629-09	1641402	S	2432	3859	6291	0.00098
Pseudonocardia sp. EC080625-04	1096868	S	217	11831	12048	0.00187
Pseudonocardia broussonetiae	2736640	S	6004	3985	9989	0.00155
Pseudonocardia dioxanivorans	240495	S	5135	2305	7440	0.00115
Pseudonocardia autotrophica	2074	S	3918	2145	6063	0.00094
Amycolatopsis sp. FDAARGOS 1241	2778070	S	3524	1297	4821	0.00075
Amycolatopsis sp. Hca4	2742131	S	2901	1690	4591	0.00071
Amycolatopsis sp. YIM 10	2653857	S	2351	1300	3651	0.00057
Amycolatopsis sp. AA4	1896961	S	2163	804	2967	0.00046
Amycolatopsis sp. BJA-103	1911175	S	1435	837	2272	0.00035
Amycolatopsis methanolica	1814	S	3018	1561	4579	0.00071
Amycolatopsis mediterranei	33910	S	2758	5857	8615	0.00134
Amycolatopsis albispora	1804986	S	2188	1514	3702	0.00057
Amycolatopsis keratiniphila	129921	S	1818	1701	3519	0.00055
Amycolatopsis orientalis	31958	S	1497	826	2323	0.00036
Amycolatopsis japonica	208439	S	943	1068	2011	0.00031
Saccharomonospora viridis	1852	S	10092	3219	13311	0.00206
Saccharomonospora marina	632569	S	1729	691	2420	0.00038
Saccharomonospora azurea	40988	S	1551	798	2349	0.00036
Saccharomonospora cyanea	40989	S	1092	599	1691	0.00026
Saccharomonospora xinjiangensis	75294	S	986	369	1355	0.00021
Saccharomonospora glauca	40990	S	876	447	1323	0.00021
Saccharothrix syringae	103733	S	3521	2068	5589	0.00087
Saccharothrix sp. 6-C	2781735	S	3192	1947	5139	0.00080
Saccharothrix espanaensis	103731	S	3017	1500	4517	0.00070
Saccharopolyspora erythraea	1836	S	3137	2292	5429	0.00084
Saccharopolyspora coralli	2665642	S	1293	422	1715	0.00027
Saccharopolyspora spinosa	60894	S	1169	1041	2210	0.00034
Saccharopolyspora pogona	333966	S	1053	1492	2545	0.00039
Saccharopolyspora sp. ASAGF58	2719023	S	698	1144	1842	0.00029
Allokutzneria albata	211114	S	5995	2447	8442	0.00131
Actinoalloteichus hoggarensis	1470176	S	1404	1780	3184	0.00049
Actinoalloteichus hymeniacidonis	340345	S	1104	578	1682	0.00026
Actinosynnema pretiosum	42197	S	1098	3764	4862	0.00075
Lentzea guizhouensis	1586287	S	3356	1348	4704	0.00073
Kutzneria albida	43357	S	3049	1257	4306	0.00067
Kibdelosporangium phytohabitans	860235	S	2965	808	3773	0.00059
Alloactinosynnema sp. L-07	1653480	S	2343	931	3274	0.00051
Prauserella marina	530584	S	1549	390	1939	0.00030
Nocardioides sp. JS614	196162	S	3384	1931	5315	0.00082
Nocardioides sp. zg-1228	2763008	S	3183	2488	5671	0.00088
Nocardioides sp. S5	2017486	S	3076	2386	5462	0.00085
Nocardioides sp. HDW12B	2714939	S	2894	1735	4629	0.00072
Nocardioides sp. S-1144	2582905	S	2483	1817	4300	0.00067
Nocardioides sp. S-713	2760089	S	2364	2084	4448	0.00069
Nocardioides sp. zg-579	2663857	S	2244	1924	4168	0.00065
Nocardioides sp. 603	2483798	S	1979	1663	3642	0.00056
Nocardioides sp. CF8	110319	S	1855	1289	3144	0.00049
Nocardioides sp. MC1495	2736757	S	1793	1202	2995	0.00046
Nocardioides sp. WS12	2486272	S	1742	761	2503	0.00039
Nocardioides sp. HDW12A	2714938	S	1596	1021	2617	0.00041
Nocardioides sp. JQ2195	2592334	S	1573	751	2324	0.00036
Nocardioides sp. dk884	2662361	S	1405	2075	3480	0.00054
Nocardioides sp. ZJ1313	2685869	S	1352	2015	3367	0.00052
Nocardioides sp. dk3136	2575373	S	1101	811	1912	0.00030
Nocardioides sp. HY056	2500546	S	784	391	1175	0.00018
Nocardioides sambongensis	2589074	S	3902	2432	6334	0.00098
Nocardioides euryhalodurans	2518370	S	3253	2159	5412	0.00084
Nocardioides anomalus	2712223	S	3036	1984	5020	0.00078
Nocardioides mesophilus	433659	S	2972	1813	4785	0.00074
Nocardioides humi	449461	S	2894	2043	4937	0.00077
Nocardioides ungokensis	1643322	S	2855	1971	4826	0.00075
Nocardioides aromaticivorans	200618	S	2571	2038	4609	0.00071
Nocardioides cynanchi	2558918	S	2331	1281	3612	0.00056
Nocardioides marinisabuli	419476	S	2024	2100	4124	0.00064
Nocardioides dokdonensis	450734	S	1785	1661	3446	0.00053
Nocardioides houyundeii	2045452	S	1643	1078	2721	0.00042
Nocardioides seonyuensis	2518371	S	1605	925	2530	0.00039
Nocardioides daphniae	402297	S	1182	1054	2236	0.00035
Nocardioides baekrokdamisoli	1804624	S	738	237	975	0.00015
Aeromicrobium sp. A1-2	2107713	S	1079	418	1497	0.00023
Aeromicrobium sp. zg-629	2663859	S	1054	656	1710	0.00027
Aeromicrobium choanae	1736691	S	1554	937	2491	0.00039
Aeromicrobium erythreum	2041	S	1543	841	2384	0.00037
Aeromicrobium chenweiae	2079793	S	1238	871	2109	0.00033
Aeromicrobium yanjiei	2662028	S	1223	813	2036	0.00032
Aeromicrobium marinum	219314	S	1134	563	1697	0.00026
Pimelobacter simplex	2045	S	2608	2072	4680	0.00073
Friedmanniella luteola	546871	S	2478	1261	3739	0.00058
Marmoricola scoriae	642780	S	2196	1666	3862	0.00060
Mumia sp. ZJ1417	2708082	S	1716	699	2415	0.00037
Micropruina glycogenica	75385	S	1371	456	1827	0.00028
Microlunatus sp. KUDC0627	2596828	S	1359	428	1787	0.00028
Microlunatus sp. Gsoil 973	2672569	S	1232	309	1541	0.00024
Microlunatus sagamiharensis	546874	S	2200	1135	3335	0.00052
Microlunatus phosphovorus	29405	S	1734	433	2167	0.00034
Microlunatus soli	630515	S	1478	408	1886	0.00029
Tessaracoccus defluvii	1285901	S	1110	818	1928	0.00030
Tessaracoccus aquimaris	1332264	S	820	517	1337	0.00021
Tessaracoccus flavescens	399497	S	798	635	1433	0.00022
Tessaracoccus sp. MC1865	2760310	S	716	360	1076	0.00017
Tessaracoccus flavus	1610493	S	697	453	1150	0.00018
Tessaracoccus timonensis	2161816	S	486	147	633	0.00010
Propionibacterium acidifaciens	556499	S	875	337	1212	0.00019
Propionibacterium freudenreichii	1744	S	775	740	1515	0.00023
Propionibacterium australiense	119981	S	739	251	990	0.00015
Propionibacterium sp. oral taxon 193	671223	S	116	60	176	0.00003
Acidipropionibacterium acidipropionici	1748	S	898	622	1520	0.00024
Acidipropionibacterium jensenii	1749	S	777	418	1195	0.00019
Acidipropionibacterium virtanenii	2057246	S	494	188	682	0.00011
Auraticoccus monumenti	675864	S	1741	759	2500	0.00039
Propioniciclava sp. HDW11	2714937	S	1326	740	2066	0.00032
Brevilactibacter sp. MC1595	2819349	S	1307	730	2037	0.00032
Raineyella sp. CBA3103	2662261	S	1073	345	1418	0.00022
Cutibacterium avidum	33010	S	465	184	649	0.00010
Cutibacterium granulosum	33011	S	306	85	391	0.00006
Cutibacterium acnes	1747	S	253	344	597	0.00009
Pseudopropionibacterium propionicum	1750	S	769	153	922	0.00014
Kribbella flavida	182640	S	4695	2269	6964	0.00108
Kribbella qitaiheensis	1544730	S	3695	1316	5011	0.00078
Actinopolymorpha singaporensis	117157	S	2796	862	3658	0.00057
Nonomuraea sp. ATCC 55076	1909395	S	5967	2624	8591	0.00133
Nonomuraea nitratireducens	2656914	S	5869	2623	8492	0.00132
Streptosporangium roseum	2001	S	3945	1889	5834	0.00090
Streptosporangium sp. 'caverna'	2202249	S	3743	1555	5298	0.00082
Thermobispora bispora	2006	S	2475	1595	4070	0.00063
Actinomadura sp. NAK00032	2742128	S	3804	2361	6165	0.00096
Actinomadura sp. WMMA1423	2591108	S	3790	2058	5848	0.00091
Actinomadura sp. WMMB 499	1219491	S	3423	1689	5112	0.00079
Actinomadura verrucosospora	46165	S	3838	2206	6044	0.00094
Thermomonospora curvata	2020	S	2523	1228	3751	0.00058
Nocardiopsis dassonvillei	2014	S	2712	1150	3862	0.00060
Nocardiopsis gilva	280236	S	1744	627	2371	0.00037
Nocardiopsis alba	53437	S	1307	441	1748	0.00027
Thermobifida fusca	2021	S	5857	3010	8867	0.00137
Streptomonospora sp. M2	2498135	S	1967	698	2665	0.00041
Geodermatophilus obscurus	1861	S	14464	8169	22633	0.00351
Modestobacter marinus	477641	S	5843	3338	9181	0.00142
Blastococcus saxobsidens	138336	S	5689	2900	8589	0.00133
Frankia sp. EAN1pec	298653	S	3498	914	4412	0.00068
Frankia sp. QA3	710111	S	1896	1446	3342	0.00052
Frankia inefficax	298654	S	4676	1292	5968	0.00093
Frankia alni	1859	S	2040	1598	3638	0.00056
Candidatus Frankia datiscae	2716812	S	1729	500	2229	0.00035
Frankia casuarinae	106370	S	1552	421	1973	0.00031
Actinomyces sp. oral taxon 414	712122	S	790	354	1144	0.00018
Actinomyces sp. ZJ750	2744574	S	430	268	698	0.00011
Actinomyces sp. Chiba101	1851395	S	364	306	670	0.00010
Actinomyces sp. Z16	2079536	S	330	248	578	0.00009
Actinomyces sp. 432	2057798	S	310	199	509	0.00008
Actinomyces sp. ZJ34	2722820	S	294	105	399	0.00006
Actinomyces sp. oral taxon 171	706438	S	194	245	439	0.00007
Actinomyces sp. zg-993	2763540	S	177	89	266	0.00004
Actinomyces sp. oral taxon 169	712116	S	114	339	453	0.00007
Actinomyces howellii	52771	S	625	220	845	0.00013
Actinomyces radicidentis	111015	S	576	313	889	0.00014
Actinomyces procaprae	2560010	S	473	287	760	0.00012
Actinomyces slackii	52774	S	449	155	604	0.00009
Actinomyces qiguomingii	2057800	S	320	101	421	0.00007
Actinomyces weissii	675090	S	285	120	405	0.00006
Actinomyces viscosus	1656	S	283	194	477	0.00007
Actinomyces wuliandei	2057743	S	253	134	387	0.00006
Actinomyces marmotae	2737173	S	250	242	492	0.00008
Actinomyces lilanjuaniae	2321394	S	219	110	329	0.00005
Actinomyces naeslundii	1655	S	212	161	373	0.00006
Actinomyces gaoshouyii	1960083	S	199	189	388	0.00006
Actinomyces israelii	1659	S	175	43	218	0.00003
Actinomyces oris	544580	S	152	368	520	0.00008
Schaalia odontolytica	1660	S	462	172	634	0.00010
Schaalia meyeri	52773	S	219	64	283	0.00004
Schaalia sp. JY-X169	2758572	S	119	8	127	0.00002
Schaalia cardiffensis	181487	S	125	23	148	0.00002
Flaviflexus salsibiostraticola	1282737	S	441	144	585	0.00009
Flaviflexus sp. dk850	2758573	S	202	52	254	0.00004
Flaviflexus sp. H23T48	2496867	S	143	22	165	0.00003
Trueperella sp. 19M2397	2733571	S	163	306	469	0.00007
Trueperella pyogenes	1661	S	222	64	286	0.00004
Trueperella bialowiezensis	312285	S	182	20	202	0.00003
Winkia sp. C64	2692125	S	370	78	448	0.00007
Pauljensenia hongkongensis	178339	S	336	149	485	0.00008
Actinobaculum sp. 313	2495645	S	162	13	175	0.00003
Actinotignum schaalii	59505	S	150	16	166	0.00003
Jiangella sp. DSM 45060	1798224	S	4171	2420	6591	0.00102
Jiangella alkaliphila	419479	S	4061	2222	6283	0.00097
Nakamurella multipartita	53461	S	3137	1116	4253	0.00066
Nakamurella sp. PAMC28650	2762325	S	1168	292	1460	0.00023
Nakamurella sp. s14-144	1902245	S	263	64	327	0.00005
Nakamurella panacisegetis	1090615	S	1340	406	1746	0.00027
Bifidobacterium choerinum	35760	S	483	153	636	0.00010
Bifidobacterium scardovii	158787	S	439	82	521	0.00008
Bifidobacterium longum	216816	S	434	498	932	0.00014
Bifidobacterium pseudolongum	1694	S	371	145	516	0.00008
Bifidobacterium subtile	77635	S	329	43	372	0.00006
Bifidobacterium animalis	28025	S	318	1720	2038	0.00032
Bifidobacterium bifidum	1681	S	279	63	342	0.00005
Bifidobacterium pullorum	78448	S	249	61	310	0.00005
Bifidobacterium adolescentis	1680	S	211	77	288	0.00004
Bifidobacterium dentium	1689	S	180	19	199	0.00003
Bifidobacterium breve	1685	S	175	6700	6875	0.00107
Bifidobacterium eulemuris	1765219	S	153	29	182	0.00003
Bifidobacterium thermophilum	33905	S	151	20	171	0.00003
Bifidobacterium actinocoloniiforme	638619	S	146	14	160	0.00002
Bifidobacterium angulatum	1683	S	143	34	177	0.00003
Bifidobacterium lemurum	1603886	S	141	29	170	0.00003
Bifidobacterium asteroides	1684	S	129	0	129	0.00002
Bifidobacterium catenulatum	1686	S	125	57	182	0.00003
Parascardovia denticolens	78258	S	121	13	134	0.00002
Catenulispora acidiphila	304895	S	3140	868	4008	0.00062
Stackebrandtia nassauensis	283811	S	2072	486	2558	0.00040
Kineococcus radiotolerans	131568	S	1746	739	2485	0.00039
Jatrophihabitans sp. GAS493	1907575	S	1235	267	1502	0.00023
Actinopolyspora erythraea	414996	S	1187	309	1496	0.00023
Epidermidibacterium keratini	1891644	S	1174	376	1550	0.00024
Acidothermus cellulolyticus	28049	S	855	125	980	0.00015
Rubrobacter sp. SCSIO 52909	2653851	S	7420	1614	9034	0.00140
Rubrobacter sp. SCSIO 52915	2653852	S	5196	1401	6597	0.00102
Rubrobacter xylanophilus	49319	S	6778	2634	9412	0.00146
Rubrobacter radiotolerans	42256	S	1933	550	2483	0.00038
Rubrobacter indicoceani	2051957	S	1127	240	1367	0.00021
Baekduia soli	496014	S	10588	4042	14630	0.00227
Conexibacter woesei	191495	S	16468	6202	22670	0.00351
Conexibacter sp. SYSU D00693	2812560	S	11600	5197	16797	0.00260
Actinomarinicola tropica	2789776	S	9827	3720	13547	0.00210
Ilumatobacter coccineus	467094	S	4139	771	4910	0.00076
Acidimicrobium ferrooxidans	53635	S	1378	207	1585	0.00025
Eggerthella sp. HF-1101	2690837	S	619	319	938	0.00015
Eggerthella sp. YY7918	502558	S	138	29	167	0.00003
Eggerthella lenta	84112	S	383	324	707	0.00011
Gordonibacter urolithinfaciens	1335613	S	313	306	619	0.00010
Gordonibacter pamelaeae	471189	S	290	314	604	0.00009
Adlercreutzia equolifaciens	446660	S	306	217	523	0.00008
Adlercreutzia sp. 8CFCBH1	2707299	S	156	168	324	0.00005
Arabia massiliensis	1870985	S	646	271	917	0.00014
Berryella intestinalis	1531429	S	361	161	522	0.00008
Slackia heliotrinireducens	84110	S	277	27	304	0.00005
Denitrobacterium detoxificans	79604	S	193	40	233	0.00004
Olsenella sp. LZLJ-2	2779519	S	344	118	462	0.00007
Olsenella sp. GAM18	2109685	S	328	159	487	0.00008
Olsenella sp. oral taxon 807	712411	S	245	23	268	0.00004
Olsenella timonensis	1805478	S	553	220	773	0.00012
Olsenella umbonata	604330	S	488	168	656	0.00010
Olsenella uli	133926	S	317	66	383	0.00006
Parolsenella massiliensis	1871022	S	301	185	486	0.00008
Parolsenella catena	2003188	S	249	171	420	0.00007
Collinsella aerofaciens	74426	S	488	217	705	0.00011
Coriobacterium glomerans	33871	S	267	25	292	0.00005
Euzebya sp. DY32-46	1608957	S	3035	656	3691	0.00057
Egibacter rhizosphaerae	1670831	S	2947	633	3580	0.00056
Egicoccus halophilus	1670830	S	2892	1094	3986	0.00062
Bacillus sp. DSL-17	2567941	S	915	230	1145	0.00018
Bacillus sp. Y1	352858	S	436	97	533	0.00008
Bacillus sp. 1NLA3E	666686	S	203	48	251	0.00004
Bacillus sp. S3	486398	S	187	34	221	0.00003
Bacillus sp. FJAT-18017	1705566	S	118	16	134	0.00002
Bacillus sp. OxB-1	98228	S	103	15	118	0.00002
Bacillus cohnii	33932	S	1930	385	2315	0.00036
Bacillus cereus	1396	S	162	973	1135	0.00018
Bacillus thuringiensis	1428	S	136	3139	3275	0.00051
[Brevibacterium] frigoritolerans	450367	S	616	6426	7042	0.00109
Bacillus marisflavi	189381	S	158	28	186	0.00003
Bacillus pumilus	1408	S	130	68	198	0.00003
Bacillus safensis	561879	S	118	218	336	0.00005
Bacillus glycinifermentans	1664069	S	116	20	136	0.00002
Priestia megaterium	1404	S	5478	9157	14635	0.00227
Priestia filamentosa	1402861	S	288	38	326	0.00005
Priestia aryabhattai	412384	S	102	688	790	0.00012
Metabacillus sp. KUDC1714	2745198	S	2257	457	2714	0.00042
Alkalihalobacillus pseudofirmus	79885	S	769	113	882	0.00014
Alkalihalobacillus krulwichiae	199441	S	338	73	411	0.00006
Alkalihalobacillus clausii	79880	S	223	31	254	0.00004
Geobacillus subterraneus	129338	S	261	362	623	0.00010
Geobacillus stearothermophilus	1422	S	114	374	488	0.00008
Geobacillus genomosp. 3	1921421	S	106	67	173	0.00003
Peribacillus simplex	1478	S	734	2771	3505	0.00054
Peribacillus asahii	228899	S	144	42	186	0.00003
Salicibibacter halophilus	2502791	S	469	59	528	0.00008
Mesobacillus jeotgali	129985	S	250	36	286	0.00004
Mesobacillus foraminis	279826	S	139	18	157	0.00002
Neobacillus cucumis	1740721	S	155	13	168	0.00003
Neobacillus mesonae	1193713	S	121	22	143	0.00002
Oceanobacillus kimchii	746691	S	136	28	164	0.00003
Weizmannia coagulans	1398	S	215	74	289	0.00004
Cytobacillus oceanisediminis	665099	S	143	33	176	0.00003
Terribacillus goriensis	386490	S	128	16	144	0.00002
Paenibacillus sp. B01	2660554	S	1019	685	1704	0.00026
Paenibacillus sp. UniB2	2726185	S	749	501	1250	0.00019
Paenibacillus sp. RUD330	2023772	S	594	112	706	0.00011
Paenibacillus sp. 32O-W	1695218	S	401	62	463	0.00007
Paenibacillus sp. PAMC21692	2762320	S	304	31	335	0.00005
Paenibacillus sp. JDR-2	324057	S	210	28	238	0.00004
Paenibacillus sp. JZ16	1906272	S	157	76	233	0.00004
Paenibacillus sp. FSL H7-0357	1536774	S	138	49	187	0.00003
Paenibacillus sp. TB2019	2810347	S	134	36	170	0.00003
Paenibacillus sp. FSL R7-0273	1536772	S	132	62	194	0.00003
Paenibacillus sp. URB8-2	2741301	S	132	57	189	0.00003
Paenibacillus sp. BIHB4019	1870819	S	130	12	142	0.00002
Paenibacillus sp. HB172198	2565926	S	111	18	129	0.00002
Paenibacillus mucilaginosus	61624	S	1135	158	1293	0.00020
Paenibacillus lycopersici	2704462	S	586	114	700	0.00011
Paenibacillus durus	44251	S	507	209	716	0.00011
Paenibacillus rhizovicinus	2704463	S	358	57	415	0.00006
Paenibacillus thiaminolyticus	49283	S	351	48	399	0.00006
Paenibacillus cellulositrophicus	562959	S	330	42	372	0.00006
Paenibacillus beijingensis	1126833	S	296	47	343	0.00005
Paenibacillus chitinolyticus	79263	S	256	41	297	0.00005
Paenibacillus cellulosilyticus	375489	S	253	34	287	0.00004
Paenibacillus ihbetae	1870820	S	226	44	270	0.00004
Paenibacillus stellifer	169760	S	226	53	279	0.00004
Paenibacillus polymyxa	1406	S	196	1147	1343	0.00021
Paenibacillus xylanilyticus	248903	S	194	45	239	0.00004
Paenibacillus albus	2495582	S	188	24	212	0.00003
Paenibacillus sabinae	365617	S	184	80	264	0.00004
Paenibacillus jilunlii	682956	S	183	257	440	0.00007
Paenibacillus donghaensis	414771	S	164	28	192	0.00003
Paenibacillus naphthalenovorans	162209	S	154	25	179	0.00003
Paenibacillus protaetiae	2509456	S	142	23	165	0.00003
Paenibacillus lutimineralis	2707005	S	107	17	124	0.00002
Paenibacillus physcomitrellae	1619311	S	100	49	149	0.00002
Brevibacillus sp. SCSIO 07484	2496837	S	396	63	459	0.00007
Brevibacillus sp. JNUCC-41	2778370	S	331	1017	1348	0.00021
Brevibacillus sp. FJAT-54423	2796470	S	294	67	361	0.00006
Brevibacillus agri	51101	S	320	70	390	0.00006
Brevibacillus brevis	1393	S	210	154	364	0.00006
Brevibacillus choshinensis	54911	S	146	26	172	0.00003
Cohnella sp. LGH	1619153	S	353	58	411	0.00006
Cohnella sp. KS 22	2598458	S	207	42	249	0.00004
Cohnella sp. MFER-1	2728023	S	197	40	237	0.00004
Cohnella candidum	2674991	S	523	106	629	0.00010
Thermobacillus composti	377615	S	903	238	1141	0.00018
Saccharibacillus brassicae	2583377	S	557	116	673	0.00010
Novibacillus thermophilus	1471761	S	11585	1057	12642	0.00196
Kroppenstedtia eburnea	714067	S	221	26	247	0.00004
Staphylospora marina	2490858	S	267	48	315	0.00005
Thermoactinomyces vulgaris	2026	S	156	21	177	0.00003
Laceyella sacchari	37482	S	131	18	149	0.00002
Alicyclobacillus acidocaldarius	405212	S	1126	126	1252	0.00019
Alicyclobacillus ferrooxydans	471514	S	234	18	252	0.00004
Tumebacillus avium	1903704	S	662	267	929	0.00014
Tumebacillus algifaecis	1214604	S	213	70	283	0.00004
Kyrpidia spormannii	2055160	S	181	92	273	0.00004
Kyrpidia tusciae	33943	S	115	75	190	0.00003
Planococcus plakortidis	1038856	S	115	127	242	0.00004
Solibacillus silvestris	76853	S	122	33	155	0.00002
Exiguobacterium mexicanum	340146	S	120	114	234	0.00004
Lactobacillus delbrueckii	1584	S	118	244	362	0.00006
Levilactobacillus zymae	267363	S	101	94	195	0.00003
Schleiferilactobacillus harbinensis	304207	S	100	22	122	0.00002
Thermaerobacter sp. FW80	2546351	S	972	382	1354	0.00021
Thermaerobacter sp. PB12/4term	2293838	S	852	365	1217	0.00019
Thermaerobacter marianensis	73919	S	979	432	1411	0.00022
Intestinimonas butyriciproducens	1297617	S	259	94	353	0.00005
Flintibacter sp. KGMB00164	2610895	S	139	47	186	0.00003
Massilistercora timonensis	2086584	S	113	86	199	0.00003
Faecalibacterium prausnitzii	853	S	747	673	1420	0.00022
Flavonifractor plautii	292800	S	438	218	656	0.00010
Caproiciproducens sp. NJN-50	2507162	S	189	39	228	0.00004
Caproiciproducens sp. 7D4C2	2721621	S	157	48	205	0.00003
Oscillibacter sp. NSJ-62	2763056	S	194	88	282	0.00004
Oscillibacter valericigenes	351091	S	159	23	182	0.00003
Ethanoligenens harbinense	253239	S	297	77	374	0.00006
Ruthenibacterium lactatiformans	1550024	S	264	114	378	0.00006
Acetivibrio saccincola	1677857	S	142	81	223	0.00003
Acutalibacter muris	1796620	S	163	19	182	0.00003
Clostridium sp. DL-VIII	641107	S	143	262	405	0.00006
Clostridium saccharoperbutylacetonicum	36745	S	120	241	361	0.00006
Hungatella hathewayi	154046	S	129	10	139	0.00002
Candidatus Desulforudis audaxviator	471827	S	400	56	456	0.00007
Desulfallas gibsoniae	102134	S	120	22	142	0.00002
Symbiobacterium thermophilum	2734	S	1477	287	1764	0.00027
Herbinix luporum	1679721	S	112	142	254	0.00004
Christensenella sp. Marseille-P3954	2086585	S	400	122	522	0.00008
Heliobacterium modesticaldum	35701	S	377	170	547	0.00008
Moorella thermoacetica	1525	S	227	38	265	0.00004
Moorella glycerini	55779	S	201	43	244	0.00004
Ammonifex degensii	42838	S	239	19	258	0.00004
Thermacetogenium phaeum	85874	S	232	140	372	0.00006
Selenomonas sp. oral taxon 126	712528	S	266	203	469	0.00007
Selenomonas sp. oral taxon 920	1884263	S	233	133	366	0.00006
Selenomonas sp. Marseille-Q3039	2754044	S	164	166	330	0.00005
Selenomonas sputigena	69823	S	373	89	462	0.00007
Sporomusa termitida	2377	S	106	24	130	0.00002
Megasphaera elsdenii	907	S	179	70	249	0.00004
Megasphaera stantonii	2144175	S	171	62	233	0.00004
Acidaminococcus fermentans	905	S	136	51	187	0.00003
Limnochorda pilosa	1555112	S	1458	180	1638	0.00025
Peptoniphilus ivorii	54006	S	102	27	129	0.00002
Synechococcus sp. CBW1004	1353136	S	495	343	838	0.00013
Synechococcus sp. RSCCF101	2511069	S	416	143	559	0.00009
Synechococcus sp. CBW1107	2789857	S	379	240	619	0.00010
Synechococcus sp. CBW1108	1353147	S	270	122	392	0.00006
Synechococcus sp. SynAce01	1916956	S	267	86	353	0.00005
Synechococcus sp. LTW-R	2751170	S	251	105	356	0.00006
Synechococcus sp. CB0101	232348	S	238	122	360	0.00006
Synechococcus sp. JA-3-3Ab	321327	S	221	215	436	0.00007
Synechococcus sp. PCC 7336	195250	S	146	7	153	0.00002
Synechococcus sp. KORDI-100	1280380	S	141	35	176	0.00003
Synechococcus sp. JA-2-3B'a(2-13)	321332	S	129	120	249	0.00004
Synechococcus sp. HK01-R	2751171	S	126	82	208	0.00003
Synechococcus sp. Minos11	221341	S	123	31	154	0.00002
Synechococcus sp. RS9909	221352	S	121	318	439	0.00007
Synechococcus sp. A15-28	1050638	S	117	186	303	0.00005
Synechococcus sp. WH 8101	59932	S	110	265	375	0.00006
Synechococcus elongatus	32046	S	166	152	318	0.00005
Cyanobium sp. NIES-981	1851505	S	416	194	610	0.00009
Cyanobium sp. NS01	261284	S	388	183	571	0.00009
Cyanobium gracile	59930	S	631	229	860	0.00013
Leptolyngbya sp. O-77	1080068	S	275	185	460	0.00007
Leptolyngbya sp. BL0902	1115757	S	234	22	256	0.00004
Halomicronema hongdechloris	1209493	S	221	12	233	0.00004
Oscillatoria nigro-viridis	482564	S	3250	398	3648	0.00057
Moorea producens	1155739	S	194	13	207	0.00003
Oxynema sp. AP17	2064643	S	206	43	249	0.00004
Microcoleus sp. PCC 7113	1173027	S	139	24	163	0.00003
Geitlerinema sp. PCC 7407	1173025	S	414	58	472	0.00007
[Phormidium] sp. ETS-05	222819	S	134	12	146	0.00002
Microcystis aeruginosa	1126	S	103	102	205	0.00003
Nostoc linckia	92942	S	120	523	643	0.00010
Scytonema sp. NIES-4073	2005464	S	120	312	432	0.00007
Gloeobacter violaceus	33072	S	892	109	1001	0.00016
Gloeobacter kilaueensis	1416614	S	736	81	817	0.00013
Chroococcidiopsis thermalis	54299	S	108	18	126	0.00002
Deinococcus sp. NW-56	2080419	S	684	156	840	0.00013
Deinococcus sp. AJ005	2652443	S	360	87	447	0.00007
Deinococcus sp. S14-83	2489213	S	320	32	352	0.00005
Deinococcus maricopensis	309887	S	1033	197	1230	0.00019
Deinococcus actinosclerus	1768108	S	895	552	1447	0.00022
Deinococcus gobiensis	502394	S	877	186	1063	0.00016
Deinococcus metallilatus	1211322	S	858	188	1046	0.00016
Deinococcus ficus	317577	S	831	157	988	0.00015
Deinococcus irradiatisoli	2202254	S	649	143	792	0.00012
Deinococcus peraridilitoris	432329	S	573	53	626	0.00010
Deinococcus wulumuqiensis	980427	S	563	290	853	0.00013
Deinococcus geothermalis	68909	S	504	2626	3130	0.00049
Deinococcus swuensis	1182571	S	491	152	643	0.00010
Deinococcus radiodurans	1299	S	451	325	776	0.00012
Deinococcus deserti	310783	S	394	43	437	0.00007
Deinococcus soli Cha et al. 2016	1309411	S	360	333	693	0.00011
Deinococcus proteolyticus	55148	S	310	47	357	0.00006
Deinococcus puniceus	1182568	S	210	22	232	0.00004
Thermus thermophilus	274	S	357	640	997	0.00015
Thermus aquaticus	271	S	273	132	405	0.00006
Thermus sp. CCB_US3_UF1	1111069	S	250	87	337	0.00005
Thermus oshimai	56957	S	236	89	325	0.00005
Thermus scotoductus	37636	S	173	127	300	0.00005
Thermus brockianus	56956	S	157	47	204	0.00003
Thermus caldilimi	2483360	S	122	71	193	0.00003
Meiothermus silvanus	52022	S	405	60	465	0.00007
Meiothermus ruber	277	S	376	147	523	0.00008
Meiothermus taiwanensis	172827	S	339	204	543	0.00008
Oceanithermus profundus	187137	S	1265	291	1556	0.00024
Marinithermus hydrothermalis	186192	S	704	151	855	0.00013
Truepera radiovictrix	332249	S	1093	125	1218	0.00019
Sphaerobacter thermophilus	2057	S	2919	469	3388	0.00053
Thermomicrobium roseum	500	S	847	64	911	0.00014
Roseiflexus sp. RS-1	357808	S	821	146	967	0.00015
Roseiflexus castenholzii	120962	S	780	182	962	0.00015
Chloroflexus aurantiacus	1108	S	402	69	471	0.00007
Chloroflexus aggregans	152260	S	278	69	347	0.00005
Tepidiforma bonchosmolovskayae	2601677	S	2044	292	2336	0.00036
Candidatus Promineofilum breve	1806508	S	1991	249	2240	0.00035
Anaerolinea thermophila	167964	S	463	82	545	0.00008
Anaerolinea sp. 'rifampicinis'	2710758	S	369	11	380	0.00006
Pelolinea submarina	913107	S	400	48	448	0.00007
Brevefilum fermentans	1986204	S	156	23	179	0.00003
Caldilinea aerophila	133453	S	1040	145	1185	0.00018
Dehalogenimonas formicexedens	1839801	S	230	44	274	0.00004
Dehalogenimonas lykanthroporepellens	552810	S	201	103	304	0.00005
Dehalogenimonas sp. GP	1536648	S	126	20	146	0.00002
Ktedonosporobacter rubrisoli	2509675	S	467	13	480	0.00007
Thermobaculum terrenum	166501	S	371	31	402	0.00006
Fimbriimonas ginsengisoli	1005039	S	1033	43	1076	0.00017
Chthonomonas calidirosea	454171	S	271	13	284	0.00004
Gemmata obscuriglobus	114	S	8419	3019	11438	0.00177
Gemmata massiliana	1210884	S	3609	2744	6353	0.00098
Gemmata sp. SH-PL17	1630693	S	3436	2950	6386	0.00099
Urbifossiella limnaea	2528023	S	15381	5138	20519	0.00318
Frigoriglobus tundricola	2774151	S	10638	4130	14768	0.00229
Limnoglobus roseus	2598579	S	7789	1570	9359	0.00145
Tuwongella immobilis	692036	S	1232	86	1318	0.00020
Lacipirellula limnantheis	2528024	S	4925	1465	6390	0.00099
Lacipirellula parvula	2650471	S	4790	1549	6339	0.00098
Pirellulimonas nuda	2528009	S	3932	1196	5128	0.00080
Botrimarina mediterranea	2528022	S	3652	1002	4654	0.00072
Aeoliella mucimassa	2527972	S	1611	228	1839	0.00029
Bythopirellula goksoyri	1400387	S	747	65	812	0.00013
Lignipirellula cremea	2528010	S	2646	493	3139	0.00049
Stieleria maiorica	2795974	S	1207	299	1506	0.00023
Stieleria neptunia	2527979	S	1206	219	1425	0.00022
Anatilimnocola aggregata	2528021	S	2514	433	2947	0.00046
Rosistilla oblonga	2527990	S	1025	388	1413	0.00022
Rosistilla carotiformis	2528017	S	503	255	758	0.00012
Pirellula staleyi	125	S	1306	144	1450	0.00022
Pirellula sp. SH-Sr6A	1632865	S	363	19	382	0.00006
Bremerella volcania	2527984	S	1220	239	1459	0.00023
Roseimaritima ulvae	980254	S	1187	191	1378	0.00021
Mariniblastus fucicola	980251	S	469	27	496	0.00008
Aureliella helgolandensis	2527968	S	451	36	487	0.00008
Rhodopirellula baltica	265606	S	442	51	493	0.00008
Thermogutta terrifontis	1331910	S	438	27	465	0.00007
Tautonia plasticadhaerens	2527974	S	8916	2608	11524	0.00179
Aquisphaera giovannonii	406548	S	7393	2750	10143	0.00157
Paludisphaera borealis	1387353	S	4766	2338	7104	0.00110
Singulisphaera acidiphila	466153	S	3675	727	4402	0.00068
Isosphaera pallida	128	S	929	96	1025	0.00016
Planctomyces sp. SH-PL62	1636152	S	4572	3138	7710	0.00120
Planctomyces sp. SH-PL14	1632864	S	3926	798	4724	0.00073
Caulifigura coniformis	2527983	S	3739	760	4499	0.00070
Gimesia panareensis	2527978	S	818	141	959	0.00015
Gimesia chilikensis	2605989	S	486	374	860	0.00013
Gimesia maris	122	S	391	77	468	0.00007
Gimesia fumaroli	2527976	S	222	53	275	0.00004
Gimesia algae	2527971	S	216	60	276	0.00004
Gimesia alba	2527973	S	210	47	257	0.00004
Gimesia aquarii	2527964	S	201	11	212	0.00003
Gimesia benthica	2608982	S	129	199	328	0.00005
Maioricimonas rarisocia	2528026	S	2774	608	3382	0.00052
Alienimonas californiensis	2527989	S	2375	547	2922	0.00045
Symmachiella dynata	2527995	S	1253	108	1361	0.00021
Fuerstia marisgermanicae	1891926	S	723	53	776	0.00012
Rubinisphaera brasiliensis	119	S	691	101	792	0.00012
Calycomorphotria hydatis	2528027	S	642	75	717	0.00011
Planctopirus ephydatiae	2528019	S	219	132	351	0.00005
Planctopirus limnophila	120	S	217	120	337	0.00005
Crateriforma conspicua	2527996	S	620	143	763	0.00012
Polystyrenella longa	2528007	S	283	23	306	0.00005
Thalassoglobus polymorphus	2527994	S	276	19	295	0.00005
Humisphaera borealis	2807512	S	3457	504	3961	0.00061
Phycisphaera mikurensis	547188	S	2009	509	2518	0.00039
Poriferisphaera corsica	2528020	S	171	6	177	0.00003
Limihaloglobus sulfuriphilus	1851148	S	105	27	132	0.00002
Anaerohalosphaera lusitana	1936003	S	212	21	233	0.00004
Opitutus sp. GAS368	1882749	S	5796	1857	7653	0.00119
Opitutus terrae	107709	S	3038	429	3467	0.00054
Lacunisphaera limnophila	1838286	S	4415	1358	5773	0.00089
Nibricoccus aquaticus	2576891	S	2044	269	2313	0.00036
Ereboglobus luteus	1796921	S	1111	134	1245	0.00019
Coraliomargarita akajimensis	395922	S	158	7	165	0.00003
Verrucomicrobium sp. GAS474	1882831	S	1523	286	1809	0.00028
Verrucomicrobium spinosum	2736	S	1080	139	1219	0.00019
Roseimicrobium sp. ORNL1	2711231	S	2162	277	2439	0.00038
Luteolibacter luteus	2728835	S	1345	127	1472	0.00023
Akkermansia muciniphila	239935	S	457	54	511	0.00008
Akkermansia glycaniphila	1679444	S	293	38	331	0.00005
Methylacidimicrobium sp. AP8	2730359	S	491	93	584	0.00009
Methylacidimicrobium sp. B4	2796139	S	394	87	481	0.00007
Candidatus Xiphinematobacter sp. Idaho Grape	1704307	S	123	7	130	0.00002
Kiritimatiella glycovorans	1307763	S	688	246	934	0.00014
Candidatus Vampirococcus archaeovorus	1930593	S	193	8	201	0.00003
Hymenobacter sp. PAMC 26554	1484116	S	479	139	618	0.00010
Hymenobacter sp. PAMC 26628	1484118	S	465	241	706	0.00011
Hymenobacter sp. APR13	1356852	S	421	241	662	0.00010
Hymenobacter sp. BRD128	2675878	S	397	129	526	0.00008
Hymenobacter sp. NBH84	2596915	S	253	61	314	0.00005
Hymenobacter sp. DG01	2584940	S	230	91	321	0.00005
Hymenobacter sp. TS19	2735321	S	196	46	242	0.00004
Hymenobacter sp. BRD67	2675877	S	180	192	372	0.00006
Hymenobacter sp. S2-20-2	2761579	S	179	56	235	0.00004
Hymenobacter sp. DG25B	1385664	S	166	101	267	0.00004
Hymenobacter sp. DG25A	1385663	S	135	85	220	0.00003
Hymenobacter sp. HDW8	2714932	S	104	265	369	0.00006
Hymenobacter busanensis	2607656	S	480	154	634	0.00010
Hymenobacter sedentarius	1411621	S	376	118	494	0.00008
Hymenobacter nivis	1850093	S	350	193	543	0.00008
Hymenobacter oligotrophus	2319843	S	309	85	394	0.00006
Hymenobacter swuensis	1446467	S	281	105	386	0.00006
Hymenobacter jejuensis	2502781	S	281	61	342	0.00005
Hymenobacter russus	2724192	S	271	90	361	0.00006
Hymenobacter baengnokdamensis	2615203	S	219	275	494	0.00008
Hymenobacter qilianensis	1385715	S	145	49	194	0.00003
Pontibacter russatus	2694929	S	513	150	663	0.00010
Pontibacter actiniarum	323450	S	254	90	344	0.00005
Pontibacter akesuensis	388950	S	158	42	200	0.00003
Pontibacter pudoricolor	2694930	S	103	24	127	0.00002
Rufibacter radiotolerans	1379910	S	144	45	189	0.00003
Rufibacter tibetensis	512763	S	110	29	139	0.00002
Rufibacter sp. DG15C	1379909	S	101	77	178	0.00003
Adhaeribacter swui	2086471	S	112	36	148	0.00002
Nibribacter ruber	2698458	S	111	85	196	0.00003
Spirosoma sp. CJU-R4	2728024	S	292	48	340	0.00005
Spirosoma sp. KUDC1026	2745947	S	245	35	280	0.00004
Spirosoma sp. KCTC 42546	2520506	S	128	15	143	0.00002
Spirosoma rigui	564064	S	235	37	272	0.00004
Spirosoma montaniterrae	1178516	S	227	68	295	0.00005
Spirosoma taeanense	2735870	S	212	34	246	0.00004
Spirosoma pollinicola	2057025	S	134	17	151	0.00002
Spirosoma aureum	2692134	S	113	74	187	0.00003
Spirosoma radiotolerans	1379870	S	109	15	124	0.00002
Spirosoma endbachense	2666025	S	106	59	165	0.00003
Dyadobacter fermentans	94254	S	491	83	574	0.00009
Dyadobacter sp. Q3-56	2747268	S	155	24	179	0.00003
Fibrella aestuarina	651143	S	331	67	398	0.00006
Fibrella sp. ES10-3-2-2	1834519	S	198	35	233	0.00004
Runella slithyformis	106	S	158	29	187	0.00003
Rhodocytophaga rosea	2704465	S	193	21	214	0.00003
Chryseolinea soli	2321403	S	1166	125	1291	0.00020
Flavobacterium commune	1306519	S	182	648	830	0.00013
Robiginitalea biformata	252307	S	145	88	233	0.00004
Blattabacterium cuenoti	1653831	S	102	169	271	0.00004
Chitinophaga sp. XS-30	2604421	S	263	215	478	0.00007
Chitinophaga sp. MD30	2033437	S	158	118	276	0.00004
Chitinophaga pinensis	79329	S	313	94	407	0.00006
Chitinophaga agri	2703787	S	134	45	179	0.00003
Chitinophaga alhagiae	2203219	S	129	30	159	0.00002
Niastella koreensis	354356	S	861	210	1071	0.00017
Lacibacter sp. S13-6-6	2760713	S	838	193	1031	0.00016
Paraflavitalea soli	2315862	S	626	148	774	0.00012
Flavisolibacter ginsenosidimutans	661481	S	238	48	286	0.00004
Flavisolibacter tropicus	1492898	S	218	62	280	0.00004
Niabella soli	446683	S	206	59	265	0.00004
Niabella ginsenosidivorans	1176587	S	189	45	234	0.00004
Pseudobacter ginsenosidimutans	661488	S	306	72	378	0.00006
Pseudocnuella soli	2502779	S	303	99	402	0.00006
Panacibacter ginsenosidivorans	1813871	S	253	56	309	0.00005
Flavihumibacter sp. SB-02	2676868	S	166	47	213	0.00003
Filimonas lacunae	477680	S	133	35	168	0.00003
Alistipes communis	2585118	S	431	288	719	0.00011
Alistipes dispar	2585119	S	427	166	593	0.00009
Alistipes megaguti	2364787	S	311	103	414	0.00006
Alistipes onderdonkii	328813	S	293	132	425	0.00007
Alistipes sp. dk3624	2662363	S	233	104	337	0.00005
Alistipes shahii	328814	S	232	190	422	0.00007
Alistipes finegoldii	214856	S	222	139	361	0.00006
Alistipes indistinctus	626932	S	210	87	297	0.00005
Prevotella dentalis	52227	S	168	57	225	0.00003
Sodaliphilus pleomorphus	2606626	S	211	158	369	0.00006
Tannerella sp. oral taxon HOT-286	712710	S	219	30	249	0.00004
Barnesiella viscericola	397865	S	106	71	177	0.00003
Rhodothermus marinus	29549	S	2162	517	2679	0.00042
Salinibacter ruber	146919	S	1316	151	1467	0.00023
Mucilaginibacter mali	2740462	S	133	195	328	0.00005
Mucilaginibacter ginsenosidivorans	398053	S	123	125	248	0.00004
Anseongella ginsenosidimutans	496056	S	112	51	163	0.00003
Haliscomenobacter hydrossis	2350	S	176	21	197	0.00003
Chlorobaculum limnaeum	274537	S	522	189	711	0.00011
Chlorobaculum tepidum	1097	S	295	134	429	0.00007
Chlorobaculum parvum	274539	S	255	86	341	0.00005
Chlorobium limicola	1092	S	130	33	163	0.00003
Chlorobium phaeobacteroides	1096	S	122	26	148	0.00002
Pelodictyon luteolum	1100	S	257	85	342	0.00005
Prosthecochloris sp. GSB1	281093	S	252	38	290	0.00005
Prosthecochloris sp. CIB 2401	1868325	S	104	32	136	0.00002
Candidatus Cyclonatronum proteinivorum	1457365	S	195	18	213	0.00003
Gemmatirosa kalamazoonesis	861299	S	15676	3354	19030	0.00295
Gemmatimonas sp. TET16	2732249	S	2955	692	3647	0.00057
Gemmatimonas aurantiaca	173480	S	2255	549	2804	0.00043
Gemmatimonas phototrophica	1379270	S	1687	382	2069	0.00032
Granulicella sp. WH15	2602070	S	1442	503	1945	0.00030
Granulicella sp. 5B5	1617967	S	1004	334	1338	0.00021
Granulicella mallensis	940614	S	1048	251	1299	0.00020
Granulicella tundricola	940615	S	866	177	1043	0.00016
Terriglobus roseus	392734	S	1468	480	1948	0.00030
Terriglobus albidus	1592106	S	1223	227	1450	0.00022
Terriglobus saanensis	870903	S	618	142	760	0.00012
Acidobacterium capsulatum	33075	S	1254	359	1613	0.00025
Acidobacterium sp. 4Y35	2763107	S	1226	175	1401	0.00022
Candidatus Koribacter versatilis	658062	S	1804	212	2016	0.00031
Edaphobacter sp. 12200R-103	2703788	S	727	200	927	0.00014
Edaphobacter sp. 4G125	2763071	S	497	120	617	0.00010
Acidisarcina polymorpha	2211140	S	924	105	1029	0.00016
Candidatus Solibacter usitatus	332163	S	4742	757	5499	0.00085
Paludibaculum fermentans	1473598	S	3771	596	4367	0.00068
Luteitalea pratensis	1855912	S	23857	3482	27339	0.00424
Chloracidobacterium thermophilum	458033	S	866	78	944	0.00015
Thermotomaculum hydrothermale	981385	S	132	6	138	0.00002
Nitrospira moscoviensis	42253	S	2778	611	3389	0.00053
Nitrospira japonica	1325564	S	1506	342	1848	0.00029
Candidatus Nitrospira inopinata	1715989	S	1411	243	1654	0.00026
Nitrospira sp. KM1	1936990	S	1125	187	1312	0.00020
Treponema primitia	88058	S	171	129	300	0.00005
Treponema brennaborense	81028	S	156	86	242	0.00004
Spirochaeta thermophila	154	S	412	41	453	0.00007
Spirochaeta africana	46355	S	157	28	185	0.00003
Turneriella parva	29510	S	307	11	318	0.00005
Fretibacterium fastidiosum	651822	S	375	34	409	0.00006
Aminomonas paucivorans	81412	S	329	70	399	0.00006
Cloacibacillus porcorum	1197717	S	304	30	334	0.00005
Thermanaerovibrio acidaminovorans	81462	S	174	64	238	0.00004
Jonquetella anthropi	428712	S	167	17	184	0.00003
Candidatus Bipolaricaulis anaerobius	2026885	S	450	37	487	0.00008
Thermotoga caldifontis	1508419	S	122	158	280	0.00004
Thermovibrio ammonificans	228745	S	104	21	125	0.00002
Thermosulfurimonas marina	2047767	S	174	89	263	0.00004
Caldithrix abyssi	187145	S	248	7	255	0.00004
Desulfurispirillum indicum	936456	S	177	26	203	0.00003
Halorubrum sp. CBA1229	1853699	S	525	181	706	0.00011
Halorubrum sp. RHB-C	2739057	S	455	242	697	0.00011
Halorubrum sp. BOL3-1	2497325	S	363	89	452	0.00007
Halorubrum sp. PV6	634157	S	307	77	384	0.00006
Halorubrum trapanicum	29284	S	353	244	597	0.00009
Halorubrum ezzemoulense	337243	S	346	120	466	0.00007
Halorubrum lacusprofundi	2247	S	295	230	525	0.00008
Halobonum sp. NJ-3-1	2743089	S	623	115	738	0.00011
Halobonum sp. Gai3-2	2743090	S	572	99	671	0.00010
Salinigranum rubrum	755307	S	482	64	546	0.00008
Halolamina sp. CBA1230	1853690	S	452	127	579	0.00009
Halopenitus persicus	1048396	S	370	69	439	0.00007
Haloplanus rubicundus	1547898	S	457	100	557	0.00009
Haloplanus rallus	1816183	S	420	151	571	0.00009
Haloplanus aerogenes	660522	S	296	59	355	0.00006
Haloferax gibbonsii	35746	S	401	247	648	0.00010
Haloferax mediterranei	2252	S	126	17	143	0.00002
Haloferax volcanii	2246	S	110	297	407	0.00006
Halobellus limi	699433	S	392	108	500	0.00008
Haloprofundus sp. MHR1	2572921	S	299	56	355	0.00006
Halogeometricum borinquense	60847	S	201	23	224	0.00003
Halalkaliarchaeum desulfuricum	2055893	S	291	27	318	0.00005
Halosimplex litoreum	1198301	S	459	130	589	0.00009
Halosimplex pelagicum	869886	S	452	162	614	0.00010
Halosimplex rubrum	869889	S	403	184	587	0.00009
Natronomonas sp. YPL13	1710540	S	591	123	714	0.00011
Natronomonas sp. C90	2747817	S	262	37	299	0.00005
Natronomonas moolapensis	416273	S	268	39	307	0.00005
Natronomonas pharaonis	2257	S	129	13	142	0.00002
Haloarcula sp. JP-L23	2716717	S	335	52	387	0.00006
Haloarcula taiwanensis	1932004	S	157	147	304	0.00005
Haloarcula marismortui	2238	S	112	148	260	0.00004
Halorhabdus utahensis	146826	S	231	41	272	0.00004
Halorhabdus tiamatea	430914	S	177	51	228	0.00004
Halorhabdus sp. CBA1104	1380432	S	133	14	147	0.00002
Halomicrobium sp. LC1Hm	2610902	S	213	387	600	0.00009
Halorientalis sp. IM1011	1932360	S	355	65	420	0.00007
Halapricum salinum	1457250	S	261	32	293	0.00005
Halobacterium hubeiense	1407499	S	449	324	773	0.00012
Halobacterium sp. DL1	751944	S	358	282	640	0.00010
Halarchaeum sp. CBA1220	1853682	S	558	98	656	0.00010
Halorussus sp. RC-68	2505977	S	257	29	286	0.00004
Halorussus sp. ZS-3	2650975	S	199	16	215	0.00003
Salarchaeum sp. JOR-1	2599399	S	305	56	361	0.00006
Halalkalicoccus jeotgali	413810	S	287	23	310	0.00005
Halodesulfurarchaeum formicicum	1873524	S	162	15	177	0.00003
Halanaeroarchaeum sulfurireducens	1604004	S	138	13	151	0.00002
Haloterrigena sp. KZCA68	2816475	S	363	135	498	0.00008
Haloterrigena sp. YPL8	1699371	S	215	26	241	0.00004
Haloterrigena turkmenica	62320	S	349	152	501	0.00008
Haloterrigena salifodinae	2675099	S	308	157	465	0.00007
Haloterrigena daqingensis	588898	S	200	28	228	0.00004
Haloterrigena longa	370324	S	172	64	236	0.00004
Natrinema sp. YPL30	1710539	S	262	78	340	0.00005
Natrinema sp. J7-2	406552	S	199	100	299	0.00005
Natrinema pellirubrum	69525	S	324	152	476	0.00007
Natrinema versiforme	88724	S	309	114	423	0.00007
Natrinema pallidum	69527	S	182	90	272	0.00004
Halovivax sp. KZCA124	2817025	S	387	50	437	0.00007
Halovivax ruber	387341	S	296	37	333	0.00005
Natrarchaeobaculum aegyptiacum	745377	S	273	58	331	0.00005
Natrarchaeobaculum sulfurireducens	2044521	S	235	40	275	0.00004
Halopiger xanaduensis	387343	S	425	121	546	0.00008
Natronococcus occultus	29288	S	411	78	489	0.00008
Salinarchaeum sp. Harcht-Bsk1	1333523	S	379	48	427	0.00007
Natronorubrum aibiense	348826	S	207	41	248	0.00004
Natronorubrum bangense	61858	S	159	30	189	0.00003
Halobiforma lacisalsi	229731	S	352	103	455	0.00007
Natrialba magadii	13769	S	272	42	314	0.00005
Halostagnicola larsenii	353800	S	208	24	232	0.00004
Natronobacterium gregoryi	44930	S	189	34	223	0.00003
Methanoculleus marisnigri	2198	S	285	32	317	0.00005
Methanoculleus bourgensis	83986	S	232	26	258	0.00004
Methanofollis liminatans	2201	S	193	19	212	0.00003
Methanosphaerula palustris	475088	S	120	8	128	0.00002
Methanosarcina barkeri	2208	S	129	112	241	0.00004
Methanosaeta harundinacea	301375	S	216	14	230	0.00004
Methanocella paludicola	570267	S	146	10	156	0.00002
Methanocella arvoryzae	1175445	S	124	7	131	0.00002
Nitrosarchaeum sp. AC2	2259673	S	5570	406	5976	0.00093
Candidatus Nitrososphaera gargensis	497727	S	2253	267	2520	0.00039
Nitrososphaera viennensis	1034015	S	454	334	788	0.00012
Candidatus Nitrososphaera evergladensis	1459637	S	451	270	721	0.00011
Candidatus Nitrosocosmicus hydrocola	1826872	S	564	262	826	0.00013
Candidatus Nitrosocosmicus oleophilus	1353260	S	325	128	453	0.00007
Candidatus Nitrosocosmicus franklandus	1798806	S	222	99	321	0.00005
Candidatus Nitrosotenuis cloacae	1603555	S	843	129	972	0.00015
Candidatus Nitrosotenuis aquarius	1846278	S	423	63	486	0.00008
Candidatus Nitrosotenuis sp. DW1	2259672	S	101	5	106	0.00002
Homo sapiens	9606	S	18407	1336	19743	0.00306
Fusarium oxysporum	5507	S	575	173	748	0.00012
Fusarium venenatum	56646	S	161	131	292	0.00005
Fusarium graminearum	5518	S	109	76	185	0.00003
Fusarium pseudograminearum	101028	S	106	66	172	0.00003
Fusarium verticillioides	117187	S	174	53	227	0.00004
Fusarium fujikuroi	5127	S	162	48	210	0.00003
Drechmeria coniospora	98403	S	613	58	671	0.00010
Pochonia chlamydosporia	280754	S	240	13	253	0.00004
Colletotrichum higginsianum	80884	S	812	168	980	0.00015
Thermothielavioides terrestris	2587410	S	891	104	995	0.00015
Thermothelomyces thermophilus	78579	S	709	75	784	0.00012
Neurospora crassa	5141	S	331	33	364	0.00006
Pyricularia pennisetigena	1578925	S	386	79	465	0.00007
Pyricularia oryzae	318829	S	307	90	397	0.00006
Pyricularia grisea	148305	S	261	58	319	0.00005
Botrytis cinerea	40559	S	394	15	409	0.00006
Aspergillus oryzae	5062	S	223	38	261	0.00004
Aspergillus fumigatus	746128	S	201	42	243	0.00004
Talaromyces rugulosus	121627	S	300	67	367	0.00006
Zymoseptoria tritici	1047171	S	318	14	332	0.00005
Cercospora beticola	122368	S	236	10	246	0.00004
Eremothecium gossypii	33169	S	156	69	225	0.00003
Yarrowia lipolytica	4952	S	130	6	136	0.00002
Sporisorium graminicola	280036	S	355	40	395	0.00006
Ustilago maydis	5270	S	236	12	248	0.00004
Malassezia restricta	76775	S	161	13	174	0.00003
Cryptococcus neoformans	5207	S	131	17	148	0.00002
Besnoitia besnoiti	94643	S	646	23	669	0.00010
Neospora caninum	29176	S	388	4	392	0.00006
Toxoplasma gondii	5811	S	383	52	435	0.00007
Plasmodium vivax	5855	S	103	125	228	0.00004
Thalassiosira pseudonana	35128	S	171	12	183	0.00003
Phaeodactylum tricornutum	2850	S	166	9	175	0.00003
Leishmania major	5664	S	293	210	503	0.00008
Leishmania mexicana	5665	S	271	119	390	0.00006
Trypanosoma brucei	5691	S	106	2	108	0.00002
Dictyostelium discoideum	44689	S	107	1	108	0.00002
