name	taxonomy_id	taxonomy_lvl	kraken_assigned_reads	added_reads	new_est_reads	fraction_total_reads
Bradyrhizobium	374	G	649637	70936	720573	0.03896
Rhodopseudomonas	1073	G	43608	10016	53624	0.00290
Nitrobacter	911	G	40103	4363	44466	0.00240
Tardiphaga	1395974	G	18965	2016	20981	0.00113
Afipia	1033	G	13594	4100	17694	0.00096
Variibacter	1649510	G	8849	529	9378	0.00051
Mesorhizobium	68287	G	340728	50539	391267	0.02115
Aminobacter	31988	G	17039	8415	25454	0.00138
Aquibium	2911176	G	16312	3178	19490	0.00105
Nitratireductor	245876	G	11045	1330	12375	0.00067
Phyllobacterium	28100	G	6663	523	7186	0.00039
Roseitalea	1915401	G	3843	516	4359	0.00024
Hoeflea	274591	G	3521	257	3778	0.00020
Oricola	1594166	G	3109	335	3444	0.00019
Salaquimonas	2712688	G	1192	40	1232	0.00007
Rhizobium	379	G	134453	31588	166041	0.00898
Agrobacterium	357	G	27369	8824	36193	0.00196
Neorhizobium	1525371	G	14299	2714	17013	0.00092
Pseudorhizobium	1903858	G	3754	588	4342	0.00023
Ensifer	106591	G	36005	5721	41726	0.00226
Sinorhizobium	28105	G	28229	11988	40217	0.00217
Shinella	323620	G	23095	13159	36254	0.00196
Ciceribacter	1648508	G	2986	482	3468	0.00019
Georhizobium	2661800	G	2862	489	3351	0.00018
Peteryoungia	2853332	G	1033	153	1186	0.00006
Methylobacterium	407	G	116445	16736	133181	0.00720
Microvirga	186650	G	89754	8322	98076	0.00530
Methylorubrum	2282523	G	24839	8634	33473	0.00181
Rhodoplanes	29407	G	129272	9774	139046	0.00752
Hyphomicrobium	81	G	55933	2430	58363	0.00316
Methyloceanibacter	1484898	G	5393	251	5644	0.00031
Aquabacter	45402	G	4657	606	5263	0.00028
Methyloligella	1485594	G	3783	331	4114	0.00022
Rhodomicrobium	1068	G	3207	156	3363	0.00018
Caenibius	2827482	G	2860	1026	3886	0.00021
Filomicrobium	119044	G	1474	27	1501	0.00008
Pseudolabrys	556257	G	66021	7827	73848	0.00399
Labrys	204476	G	63503	5117	68620	0.00371
Starkeya	152053	G	21696	4551	26247	0.00142
Ancylobacter	99	G	17010	4844	21854	0.00118
Xanthobacter	279	G	15641	2971	18612	0.00101
Azorhizobium	6	G	5378	917	6295	0.00034
Devosia	46913	G	73212	4954	78166	0.00423
Youhaiella	1827478	G	6671	1479	8150	0.00044
Paradevosia	1573407	G	6195	2099	8294	0.00045
Pelagibacterium	1082930	G	2356	240	2596	0.00014
Bosea	85413	G	85680	10967	96647	0.00522
Nordella	169055	G	22790	984	23774	0.00129
Pseudorhodoplanes	1734920	G	13869	803	14672	0.00079
Terrihabitans	2874214	G	3760	332	4092	0.00022
Aureimonas	414371	G	21767	3500	25267	0.00137
Martelella	293088	G	11864	1656	13520	0.00073
Aurantimonas	182269	G	6003	1456	7459	0.00040
Methylocystis	133	G	18096	1296	19392	0.00105
Methylosinus	425	G	8630	1063	9693	0.00052
Stappia	152161	G	8755	1305	10060	0.00054
Pannonibacter	227873	G	4595	2586	7181	0.00039
Roseibium	150830	G	4545	505	5050	0.00027
Labrenzia	478070	G	3628	274	3902	0.00021
Phreatobacter	1632780	G	22024	2907	24931	0.00135
Kaustia	2838250	G	6757	515	7272	0.00039
Parvibaculum	256616	G	3681	1979	5660	0.00031
Pyruvatibacter	1742974	G	2339	239	2578	0.00014
Candidatus Phaeomarinobacter	1541445	G	1006	42	1048	0.00006
Methylocella	120652	G	6434	509	6943	0.00038
Methylovirgula	1156568	G	5482	381	5863	0.00032
Beijerinckia	532	G	1612	115	1727	0.00009
Chelatococcus	28209	G	13294	2333	15627	0.00084
Brucella	234	G	11053	11259	22312	0.00121
Pseudochrobactrum	354349	G	1114	157	1271	0.00007
Blastochloris	59282	G	12187	2248	14435	0.00078
Kaistia	166953	G	10701	2068	12769	0.00069
Acuticoccus	1904377	G	6748	561	7309	0.00040
Hartmannibacter	1572860	G	4816	679	5495	0.00030
Breoghania	1406135	G	4526	467	4993	0.00027
Lichenihabitans	2723776	G	4447	157	4604	0.00025
Bartonella	773	G	1090	55	1145	0.00006
Sphingomonas	13687	G	304247	34339	338586	0.01830
Sphingobium	165695	G	85603	40965	126568	0.00684
Sphingopyxis	165697	G	60786	10119	70905	0.00383
Novosphingobium	165696	G	57093	15796	72889	0.00394
Rhizorhabdus	1649486	G	20031	7650	27681	0.00150
Sphingosinithalassobacter	2676233	G	9343	1742	11085	0.00060
Allosphingosinicella	2823232	G	5440	508	5948	0.00032
Parasphingopyxis	1234545	G	4071	149	4220	0.00023
Sphingorhabdus	1434046	G	3987	177	4164	0.00023
Blastomonas	150203	G	3838	491	4329	0.00023
Tardibacter	2685927	G	3252	1988	5240	0.00028
Hankyongella	1763827	G	2852	429	3281	0.00018
Citromicrobium	72173	G	2172	773	2945	0.00016
Novosphingopyxis	2709686	G	1768	761	2529	0.00014
Parasphingorhabdus	2709685	G	1159	25	1184	0.00006
Aquisediminimonas	2676781	G	1130	31	1161	0.00006
Erythrobacter	1041	G	27289	5829	33118	0.00179
Porphyrobacter	1111	G	9369	2136	11505	0.00062
Qipengyuania	1855416	G	16963	3644	20607	0.00111
Tsuneonella	2800686	G	12863	2059	14922	0.00081
Altererythrobacter	361177	G	11713	2525	14238	0.00077
Croceicoccus	1295327	G	9846	5064	14910	0.00081
Aurantiacibacter	2800681	G	2038	289	2327	0.00013
Pelagerythrobacter	2800685	G	1819	204	2023	0.00011
Croceibacterium	2676755	G	1774	664	2438	0.00013
Paraurantiacibacter	2800682	G	1740	180	1920	0.00010
Sphingosinicella	335405	G	12859	1085	13944	0.00075
Polymorphobacter	1508451	G	7760	253	8013	0.00043
Sandaracinobacter	56358	G	3147	177	3324	0.00018
Roseomonas	125216	G	51398	5055	56453	0.00305
Rhodovastum	504465	G	8810	629	9439	0.00051
Komagataeibacter	1434011	G	6659	2621	9280	0.00050
Roseococcus	35812	G	6210	425	6635	0.00036
Acidiphilium	522	G	5446	2131	7577	0.00041
Sediminicoccus	1706033	G	5347	203	5550	0.00030
Acetobacter	434	G	3890	1140	5030	0.00027
Lichenicola	2804525	G	3881	135	4016	0.00022
Acidibrevibacterium	2603324	G	3740	252	3992	0.00022
Gluconobacter	441	G	2652	530	3182	0.00017
Gluconacetobacter	89583	G	2473	412	2885	0.00016
Granulibacter	364409	G	1771	113	1884	0.00010
Asaia	91914	G	1217	154	1371	0.00007
Neoasaia	320496	G	1015	167	1182	0.00006
Azospirillum	191	G	66819	6507	73326	0.00396
Skermanella	204447	G	21156	2307	23463	0.00127
Nitrospirillum	1543705	G	5752	514	6266	0.00034
Indioceanicola	2478349	G	4127	437	4564	0.00025
Niveispirillum	1543704	G	2517	213	2730	0.00015
Hypericibacter	2705399	G	56384	2550	58934	0.00319
Magnetospirillum	13134	G	13752	208151	221903	0.01200
Rhodospirillum	1081	G	7958	671	8629	0.00047
Ferrovibrio	1231242	G	7140	344	7484	0.00040
Tistrella	171436	G	5752	1915	7667	0.00041
Defluviicoccus	111830	G	2792	188	2980	0.00016
Pararhodospirillum	1612157	G	1779	95	1874	0.00010
Stella	93	G	12017	626	12643	0.00068
Elioraea	457933	G	5071	183	5254	0.00028
Thalassospira	168934	G	2666	170	2836	0.00015
Magnetospira	1182780	G	1236	28	1264	0.00007
Paracoccus	265	G	39348	5669	45017	0.00243
Rhodobacter	1060	G	9948	2348	12296	0.00066
Cereibacter	1653176	G	9694	2164	11858	0.00064
Rhodovulum	34008	G	5642	1016	6658	0.00036
Polymorphum	991903	G	4703	932	5635	0.00030
Paroceanicella	2683599	G	4225	895	5120	0.00028
Thioclava	285107	G	3124	318	3442	0.00019
Pikeienuella	2831955	G	2781	216	2997	0.00016
Pontivivens	1844015	G	2746	162	2908	0.00016
Pelagovum	2795377	G	2449	248	2697	0.00015
Silicimonas	1955420	G	2434	117	2551	0.00014
Tabrizicola	1443919	G	2270	165	2435	0.00013
Frigidibacter	1775705	G	2089	712	2801	0.00015
Pukyongiella	2831925	G	1848	366	2214	0.00012
Brevirhabdus	1855413	G	1758	678	2436	0.00013
Fuscovulum	2818469	G	1719	177	1896	0.00010
Gemmobacter	204456	G	1537	237	1774	0.00010
Gymnodinialimonas	2937410	G	1467	112	1579	0.00009
Falsirhodobacter	1434002	G	1438	164	1602	0.00009
Haematobacter	366614	G	1408	463	1871	0.00010
Pacificitalea	2846749	G	1306	237	1543	0.00008
Pseudopuniceibacterium	2613960	G	1273	81	1354	0.00007
Pseudooceanicola	1679449	G	1152	91	1243	0.00007
Roseicitreum	1209946	G	1062	44	1106	0.00006
Monaibacterium	2029873	G	1022	196	1218	0.00007
Sulfitobacter	60136	G	10088	1498	11586	0.00063
Roseovarius	74030	G	10057	1218	11275	0.00061
Salipiger	263377	G	7476	1887	9363	0.00051
Roseivivax	93682	G	5688	679	6367	0.00034
Celeribacter	875170	G	4474	1328	5802	0.00031
Phaeobacter	302485	G	3987	2951	6938	0.00038
Leisingera	191028	G	3599	380	3979	0.00022
Ruegeria	97050	G	3589	394	3983	0.00022
Pseudosulfitobacter	2854186	G	2839	606	3445	0.00019
Yangia	2919626	G	2597	335	2932	0.00016
Sagittula	58842	G	2479	785	3264	0.00018
Mameliella	1434019	G	1907	272	2179	0.00012
Ponticoccus	983507	G	1886	220	2106	0.00011
Roseobacter	2433	G	1741	35	1776	0.00010
Dinoroseobacter	309512	G	1714	482	2196	0.00012
Ketogulonicigenium	92944	G	1627	143	1770	0.00010
Octadecabacter	53945	G	1574	84	1658	0.00009
Roseibacterium	159345	G	1441	94	1535	0.00008
Oceanicola	252301	G	1364	54	1418	0.00008
Actibacterium	1433986	G	1345	516	1861	0.00010
Thalassococcus	436357	G	1081	21	1102	0.00006
Caulobacter	75	G	80275	8481	88756	0.00480
Brevundimonas	41275	G	48137	5612	53749	0.00291
Phenylobacterium	20	G	27794	3918	31712	0.00171
Asticcacaulis	76890	G	4239	270	4509	0.00024
Terricaulis	2768684	G	2432	65	2497	0.00014
Marinicauda	1649466	G	3281	447	3728	0.00020
Maricaulis	74317	G	1216	62	1278	0.00007
Glycocaulis	1433402	G	1124	48	1172	0.00006
Hyphomonas	85	G	4054	152	4206	0.00023
Candidatus Viadribacter	2892997	G	1530	32	1562	0.00008
Aquisalinus	1795639	G	1451	58	1509	0.00008
Micavibrio	213485	G	1080	11	1091	0.00006
Burkholderia	32008	G	198291	112258	310549	0.01679
Cupriavidus	106589	G	131305	41977	173282	0.00937
Paraburkholderia	1822464	G	108041	9552	117593	0.00636
Caballeronia	1827195	G	41330	4534	45864	0.00248
Pandoraea	93217	G	34910	5667	40577	0.00219
Ralstonia	48736	G	30460	19161	49621	0.00268
Polynucleobacter	44013	G	3928	77	4005	0.00022
Lautropia	47670	G	2012	291	2303	0.00012
Chitinimonas	240411	G	1715	110	1825	0.00010
Mycetohabitans	2571159	G	1485	77	1562	0.00008
Variovorax	34072	G	178707	52507	231214	0.01250
Hydrogenophaga	47420	G	59020	21539	80559	0.00436
Acidovorax	12916	G	54784	23934	78718	0.00426
Ramlibacter	174951	G	52153	18913	71066	0.00384
Rhodoferax	28065	G	31858	6929	38787	0.00210
Comamonas	283	G	29137	12082	41219	0.00223
Polaromonas	52972	G	28283	1962	30245	0.00164
Diaphorobacter	238749	G	16318	14044	30362	0.00164
Schlegelella	215579	G	16040	4339	20379	0.00110
Delftia	80865	G	14425	13597	28022	0.00151
Kinneretia	683756	G	10447	4898	15345	0.00083
Ottowia	219181	G	9087	1408	10495	0.00057
Alicycliphilus	201096	G	7985	11665	19650	0.00106
Melaminivora	1649468	G	6669	4960	11629	0.00063
Hylemonella	232523	G	4250	548	4798	0.00026
Serpentinimonas	2490452	G	4076	769	4845	0.00026
Verminephrobacter	364316	G	3712	409	4121	0.00022
Pulveribacter	2678886	G	3138	1498	4636	0.00025
Simplicispira	352450	G	2481	766	3247	0.00018
Limnohabitans	665874	G	1702	147	1849	0.00010
Curvibacter	281915	G	1203	78	1281	0.00007
Massilia	149698	G	94814	13833	108647	0.00587
Duganella	75654	G	8827	2573	11400	0.00062
Herbaspirillum	963	G	21338	3484	24822	0.00134
Janthinobacterium	29580	G	20695	7190	27885	0.00151
Collimonas	202907	G	11011	1037	12048	0.00065
Noviherbaspirillum	1344552	G	7488	1081	8569	0.00046
Undibacterium	401469	G	1558	77	1635	0.00009
Achromobacter	222	G	61128	21735	82863	0.00448
Bordetella	517	G	55439	21358	76797	0.00415
Pigmentiphaga	152267	G	8362	808	9170	0.00050
Orrella	1921582	G	3841	1000	4841	0.00026
Castellaniella	359336	G	3484	1921	5405	0.00029
Alcaligenes	507	G	2637	542	3179	0.00017
Pusillimonas (ex Stolz et al. 2005)	305976	G	1984	293	2277	0.00012
Paralcaligenes	1148163	G	1223	42	1265	0.00007
Advenella	290425	G	1133	27	1160	0.00006
Kerstersia	257820	G	1091	193	1284	0.00007
Rhizobacter	212743	G	24101	4907	29008	0.00157
Methylibium	316612	G	16276	5018	21294	0.00115
Sphaerotilus	34102	G	13937	6025	19962	0.00108
Aquincola	391952	G	12431	3847	16278	0.00088
Rubrivivax	28067	G	11773	3330	15103	0.00082
Thiomonas	32012	G	7778	411	8189	0.00044
Leptothrix	88	G	7392	2174	9566	0.00052
Mitsuaria	65047	G	7100	1284	8384	0.00045
Xylophilus	54066	G	5736	1491	7227	0.00039
Ideonella	36862	G	4985	2691	7676	0.00042
Roseateles	93681	G	3448	601	4049	0.00022
Tepidimonas	114248	G	3398	1056	4454	0.00024
Aquabacterium	92793	G	3369	803	4172	0.00023
Inhella	644355	G	2418	343	2761	0.00015
Paucibacter	318147	G	2185	336	2521	0.00014
Sutterella	40544	G	2493	162	2655	0.00014
Usitatibacter	2803845	G	44738	2907	47645	0.00258
Nitrosospira	35798	G	35338	958	36296	0.00196
Nitrosomonas	914	G	5783	429	6212	0.00034
Denitratisoma	311181	G	4945	2068	7013	0.00038
Sulfuritalea	1054211	G	3971	559	4530	0.00024
Methyloversatilis	378210	G	3523	409	3932	0.00021
Sterolibacterium	157591	G	2556	601	3157	0.00017
Sideroxydans	314343	G	3881	499	4380	0.00024
Ferrigenium	2249462	G	2866	561	3427	0.00019
Sulfuriferula	1778653	G	3310	462	3772	0.00020
Sulfurimicrobium	2772198	G	3055	365	3420	0.00018
Sulfuricella	935200	G	1525	132	1657	0.00009
Thiobacillus	919	G	4493	749	5242	0.00028
Sulfuritortus	1938335	G	3241	1205	4446	0.00024
Methylovorus	81682	G	1529	154	1683	0.00009
Methylobacillus	404	G	1093	288	1381	0.00007
Thauera	33057	G	20852	10851	31703	0.00171
Azoarcus	12960	G	17270	4892	22162	0.00120
Nitrogeniibacter	2891294	G	5790	773	6563	0.00035
Aromatoleum	551759	G	16050	4038	20088	0.00109
Azospira	146937	G	11758	4528	16286	0.00088
Niveibacterium	1769726	G	3134	371	3505	0.00019
Oryzomicrobium	1911577	G	2358	560	2918	0.00016
Dechloromonas	73029	G	5302	798	6100	0.00033
Ferribacterium	88875	G	4336	659	4995	0.00027
Quatrionicoccus	138117	G	2020	552	2572	0.00014
Chromobacterium	535	G	16312	3053	19365	0.00105
Pseudogulbenkiania	568394	G	6854	1937	8791	0.00048
Jeongeupia	885864	G	4724	720	5444	0.00029
Paludibacterium	400060	G	4123	582	4705	0.00025
Vogesella	57739	G	2999	627	3626	0.00020
Aquitalea	407217	G	2643	431	3074	0.00017
Microvirgula	57479	G	2056	327	2383	0.00013
Laribacter	168470	G	1494	1051	2545	0.00014
Aquaspirillum	187	G	1001	123	1124	0.00006
Neisseria	482	G	6506	2037	8543	0.00046
Crenobacter	1654931	G	3331	910	4241	0.00023
Chitinolyticbacter	1055692	G	2324	241	2565	0.00014
Vitreoscilla	59	G	1558	224	1782	0.00010
Casimicrobium	2706000	G	2638	999	3637	0.00020
Lysobacter	68	G	220443	27507	247950	0.01340
Stenotrophomonas	40323	G	49236	17942	67178	0.00363
Xanthomonas	338	G	48266	19921	68187	0.00369
Luteimonas	83614	G	31923	5321	37244	0.00201
Pseudoxanthomonas	83618	G	28282	10286	38568	0.00209
Thermomonas	141948	G	20195	4715	24910	0.00135
Arenimonas	490567	G	7986	1310	9296	0.00050
Pseudolysobacter	2709666	G	3007	62	3069	0.00017
Frateuria	70411	G	21543	4772	26315	0.00142
Luteibacter	242605	G	19138	1735	20873	0.00113
Rhodanobacter	75309	G	19030	3441	22471	0.00121
Dyella	231454	G	17509	2606	20115	0.00109
Dokdonella	323413	G	9250	1274	10524	0.00057
Aerosticca	2707020	G	3762	3830	7592	0.00041
Ahniella	2233801	G	1754	34	1788	0.00010
Pseudomonas	286	G	477813	112284	590097	0.03190
Azotobacter	352	G	6171	3756	9927	0.00054
Halopseudomonas	2901189	G	3737	528	4265	0.00023
Marinobacter	2742	G	7970	508	8478	0.00046
Klebsiella	570	G	8721	38226	46947	0.00254
Raoultella	160674	G	2328	1182	3510	0.00019
Enterobacter	547	G	9770	12145	21915	0.00118
Citrobacter	544	G	4682	3890	8572	0.00046
Cronobacter	413496	G	2818	493	3311	0.00018
Kosakonia	1330547	G	2561	344	2905	0.00016
Leclercia	83654	G	2494	1184	3678	0.00020
Salmonella	590	G	2229	36067	38296	0.00207
Escherichia	561	G	1709	20339	22048	0.00119
Pluralibacter	1330546	G	1664	344	2008	0.00011
Cedecea	158483	G	1377	158	1535	0.00008
Serratia	613	G	14728	3138	17866	0.00097
Yersinia	629	G	1746	1122	2868	0.00016
Rahnella	34037	G	1575	334	1909	0.00010
Pantoea	53335	G	9065	1325	10390	0.00056
Erwinia	551	G	3619	678	4297	0.00023
Mixta	2100764	G	1966	492	2458	0.00013
Dickeya	204037	G	4418	4303	8721	0.00047
Pectobacterium	122277	G	2571	369	2940	0.00016
Brenneria	71655	G	1574	98	1672	0.00009
Edwardsiella	635	G	2383	1715	4098	0.00022
Sodalis	84565	G	1782	92	1874	0.00010
Thioalkalivibrio	106633	G	9879	1455	11334	0.00061
Spiribacter	1335745	G	5890	331	6221	0.00034
Acidihalobacter	1765964	G	4306	279	4585	0.00025
Halorhodospira	85108	G	2042	132	2174	0.00012
Aquisalimonas	406099	G	1938	108	2046	0.00011
Alkalilimnicola	133193	G	1695	171	1866	0.00010
Ectothiorhodospira	1051	G	1669	128	1797	0.00010
Allochromatium	85072	G	3551	690	4241	0.00023
Thiodictyon	53392	G	3501	152	3653	0.00020
Marichromatium	85076	G	2873	450	3323	0.00018
Thioflavicoccus	156885	G	2710	196	2906	0.00016
Thiocapsa	1056	G	2300	101	2401	0.00013
Thiocystis	13724	G	1853	129	1982	0.00011
Thermochromatium	85073	G	1125	233	1358	0.00007
Wenzhouxiangella	1676142	G	3135	120	3255	0.00018
Thiohalobacter	1273155	G	2369	237	2606	0.00014
Sulfurivermis	2034504	G	2007	602	2609	0.00014
Guyparkeria	2035712	G	1901	339	2240	0.00012
Halothiobacillus	109262	G	1281	82	1363	0.00007
Halomonas	2745	G	35835	4100	39935	0.00216
Cobetia	204286	G	2347	1307	3654	0.00020
Salinicola	404432	G	1995	174	2169	0.00012
Halotalea	376488	G	1931	289	2220	0.00012
Kushneria	504090	G	1520	56	1576	0.00009
Chromohalobacter	42054	G	1256	104	1360	0.00007
Alcanivorax	59753	G	4753	1547	6300	0.00034
Marinobacterium	48075	G	1587	158	1745	0.00009
Hahella	158481	G	1100	34	1134	0.00006
Aeromonas	642	G	20222	13076	33298	0.00180
Zobellella	347533	G	1338	271	1609	0.00009
Methylococcus	413	G	6896	407	7303	0.00039
Methylomonas	416	G	5164	142	5306	0.00029
Methylomagnum	1760987	G	2134	76	2210	0.00012
Methylomicrobium	39773	G	1865	449	2314	0.00013
Methylogaea	1295378	G	1845	118	1963	0.00011
Methylocaldum	73778	G	1681	80	1761	0.00010
Shewanella	22	G	7478	1260	8738	0.00047
Alteromonas	226	G	1230	235	1465	0.00008
Pseudoalteromonas	53246	G	2626	280	2906	0.00016
Microbulbifer	48073	G	6581	368	6949	0.00038
Cellvibrio	10	G	1806	76	1882	0.00010
Kineobactrum	2678529	G	1142	91	1233	0.00007
Solimonas	413435	G	6768	516	7284	0.00039
Flagellatimonas	2893022	G	2168	111	2279	0.00012
Sinimarinibacterium	1861863	G	1123	469	1592	0.00009
Steroidobacter	469322	G	3728	805	4533	0.00025
Sulfurifustis	1692042	G	6687	344	7031	0.00038
Sulfuricaulis	1744881	G	3192	202	3394	0.00018
Acidiferrobacter	986106	G	2202	34	2236	0.00012
Legionella	445	G	7448	607	8055	0.00044
Aquicella	254245	G	1947	93	2040	0.00011
Vibrio	662	G	7783	1838	9621	0.00052
Photobacterium	657	G	1090	180	1270	0.00007
Acinetobacter	469	G	4653	1473	6126	0.00033
Immundisolibacter	1934947	G	6363	880	7243	0.00039
Thiothrix	1030	G	1317	41	1358	0.00007
Salinisphaera	180541	G	2130	1955	4085	0.00022
Cardiobacterium	2717	G	1202	127	1329	0.00007
Sorangium	39643	G	123333	11662	134995	0.00730
Polyangium	55	G	23506	1631	25137	0.00136
Chondromyces	50	G	11282	380	11662	0.00063
Sandaracinus	1055688	G	42324	1627	43951	0.00238
Labilithrix	1524217	G	22522	751	23273	0.00126
Myxococcus	32	G	23036	44051	67087	0.00363
Corallococcus	83461	G	21941	1099	23040	0.00125
Pyxidicoccus	224458	G	20518	558	21076	0.00114
Anaeromyxobacter	161492	G	62813	3172	65985	0.00357
Archangium	47	G	25276	2571	27847	0.00151
Stigmatella	40	G	7391	421	7812	0.00042
Cystobacter	42	G	6981	1785	8766	0.00047
Melittangium	44	G	5552	1268	6820	0.00037
Vulgatibacter	1524214	G	6552	345	6897	0.00037
Haliangium	162027	G	16913	632	17545	0.00095
Geomonas	2651583	G	11022	1454	12476	0.00067
Geobacter	28231	G	9171	769	9940	0.00054
Citrifermentans	2883512	G	3260	649	3909	0.00021
Geotalea	2910589	G	1641	86	1727	0.00009
Desulfuromonas	890	G	6976	659	7635	0.00041
Pelobacter	18	G	1096	293	1389	0.00008
Syntrophotalea	2812025	G	1435	125	1560	0.00008
Desulfovibrio	872	G	7054	724	7778	0.00042
Pseudodesulfovibrio	2035811	G	6804	1004	7808	0.00042
Solidesulfovibrio	2910984	G	4338	360	4698	0.00025
Oceanidesulfovibrio	2905722	G	1700	82	1782	0.00010
Desulfocurvibacter	2582840	G	1315	73	1388	0.00008
Desulfolutivibrio	2773294	G	1169	258	1427	0.00008
Megalodesulfovibrio	2910978	G	1064	41	1105	0.00006
Desulfomicrobium	898	G	1384	133	1517	0.00008
Desulfosarcina	2299	G	3026	428	3454	0.00019
Desulfobulbus	893	G	1809	262	2071	0.00011
Persicimonas	2766927	G	5233	121	5354	0.00029
Bradymonas	1779136	G	1922	830	2752	0.00015
Syntrophobacter	29526	G	1126	353	1479	0.00008
Desulfarculus	453229	G	1760	771	2531	0.00014
Campylobacter	194	G	1734	251	1985	0.00011
Bdellovibrio	958	G	2211	78	2289	0.00012
Acidithiobacillus	119977	G	2799	224	3023	0.00016
Streptomyces	1883	G	1610659	282950	1893609	0.10237
Kitasatospora	2063	G	23355	5754	29109	0.00157
Streptacidiphilus	228398	G	17233	3414	20647	0.00112
Yinghuangia	2805681	G	9221	1009	10230	0.00055
Microbacterium	33882	G	217563	26960	244523	0.01322
Agromyces	33877	G	67480	11862	79342	0.00429
Leifsonia	110932	G	59818	23097	82915	0.00448
Curtobacterium	2034	G	32689	4953	37642	0.00204
Protaetiibacter	2680004	G	31785	6841	38626	0.00209
Rathayibacter	33886	G	28935	4749	33684	0.00182
Clavibacter	1573	G	21181	11556	32737	0.00177
Leucobacter	55968	G	20209	2689	22898	0.00124
Agrococcus	46352	G	19495	3817	23312	0.00126
Salinibacterium	235888	G	11555	1451	13006	0.00070
Cryobacterium	69578	G	8404	843	9247	0.00050
Frondihabitans	447237	G	6621	759	7380	0.00040
Microterricola	518733	G	6221	1116	7337	0.00040
Microcella	337004	G	6149	1566	7715	0.00042
Plantibacter	190323	G	5937	549	6486	0.00035
Herbiconiux	881616	G	4502	657	5159	0.00028
Cnuibacter	1759331	G	4223	669	4892	0.00026
Frigoribacterium	96492	G	3850	825	4675	0.00025
Mycetocola	76634	G	3743	338	4081	0.00022
Gryllotalpicola	1195526	G	3669	513	4182	0.00023
Subtercola	120212	G	3632	215	3847	0.00021
Amnibacterium	1029631	G	3395	594	3989	0.00022
Humibacter	427753	G	3359	544	3903	0.00021
Chryseoglobus	1331730	G	3279	475	3754	0.00020
Marisediminicola	1230698	G	2526	227	2753	0.00015
Diaminobutyricimonas	1433997	G	2437	331	2768	0.00015
Glaciihabitans	1649454	G	2156	124	2280	0.00012
Gulosibacter	256818	G	2096	429	2525	0.00014
Agreia	110934	G	1930	169	2099	0.00011
Arthrobacter	1663	G	201313	38147	239460	0.01295
Pseudarthrobacter	1742993	G	42723	10710	53433	0.00289
Sinomonas	596707	G	27178	5094	32272	0.00174
Kocuria	57493	G	17783	3712	21495	0.00116
Micrococcus	1269	G	8347	3951	12298	0.00066
Paenarthrobacter	1742992	G	6599	2715	9314	0.00050
Glutamicibacter	1742989	G	6129	1393	7522	0.00041
Rothia	32207	G	3781	1087	4868	0.00026
Citricoccus	169133	G	2900	532	3432	0.00019
Cellulomonas	1707	G	72057	18664	90721	0.00490
Actinotalea	458839	G	4589	1284	5873	0.00032
Oerskovia	162491	G	3529	872	4401	0.00024
Pseudactinotalea	1926259	G	2925	319	3244	0.00018
Paraoerskovia	665568	G	2418	479	2897	0.00016
Janibacter	53457	G	14527	3248	17775	0.00096
Phycicoccus	367298	G	13092	2910	16002	0.00087
Intrasporangium	53357	G	10352	2011	12363	0.00067
Pedococcus	2805645	G	9961	2386	12347	0.00067
Tetrasphaera	99479	G	6679	1416	8095	0.00044
Arsenicicoccus	267408	G	4440	1292	5732	0.00031
Cellulosimicrobium	157920	G	21710	6972	28682	0.00155
Xylanimonas	186188	G	11059	2678	13737	0.00074
Isoptericola	254250	G	7751	2655	10406	0.00056
Ornithinimicrobium	125287	G	16840	2656	19496	0.00105
Serinicoccus	265976	G	12746	2660	15406	0.00083
Brachybacterium	43668	G	21146	2570	23716	0.00128
Dermabacter	36739	G	1514	602	2116	0.00011
Brevibacterium	1696	G	22175	3268	25443	0.00138
Georgenia	154116	G	20332	4300	24632	0.00133
Dermacoccus	57495	G	5639	1482	7121	0.00039
Luteipulveratus	745364	G	3977	419	4396	0.00024
Allobranchiibius	2040262	G	3329	550	3879	0.00021
Yimella	908935	G	1990	297	2287	0.00012
Ruania	626119	G	13262	1168	14430	0.00078
Pengzhenrongella	2888818	G	4982	1049	6031	0.00033
Luteimicrobium	754249	G	4490	1051	5541	0.00030
Beutenbergia	84756	G	5369	680	6049	0.00033
Miniimonas	947525	G	3747	1505	5252	0.00028
Sanguibacter	60919	G	6768	1535	8303	0.00045
Gephyromycinifex	2885697	G	1449	122	1571	0.00008
Austwickia	1184606	G	1049	59	1108	0.00006
Kytococcus	57499	G	2629	703	3332	0.00018
Demequina	577469	G	1253	71	1324	0.00007
Micromonospora	1873	G	545140	98146	643286	0.03478
Actinoplanes	1865	G	105149	12936	118085	0.00638
Dactylosporangium	35753	G	66524	4985	71509	0.00387
Phytohabitans	907364	G	26385	2274	28659	0.00155
Plantactinospora	673534	G	19923	2260	22183	0.00120
Catellatospora	53365	G	16365	2404	18769	0.00101
Actinocatenispora	390988	G	15679	1341	17020	0.00092
Couchioplanes	56433	G	14281	2260	16541	0.00089
Polymorphospora	338583	G	10021	1390	11411	0.00062
Natronosporangium	2920401	G	4741	221	4962	0.00027
Verrucosispora	84593	G	4253	1764	6017	0.00033
Salinispora	168694	G	3106	317	3423	0.00019
Mycolicibacterium	1866885	G	200887	27974	228861	0.01237
Mycobacterium	1763	G	200471	33912	234383	0.01267
Mycolicibacter	1073531	G	10557	2857	13414	0.00073
Mycobacteroides	670516	G	9013	1639	10652	0.00058
Mycolicibacillus	2126281	G	2100	391	2491	0.00013
Nocardia	1817	G	124664	14988	139652	0.00755
Rhodococcus	1827	G	90116	19393	109509	0.00592
Corynebacterium	1716	G	57927	11016	68943	0.00373
Gordonia	2053	G	47009	7456	54465	0.00294
Skermania	59613	G	2092	170	2262	0.00012
Tsukamurella	2060	G	14581	2620	17201	0.00093
Dietzia	37914	G	8582	1449	10031	0.00054
Tomitella	741759	G	5197	765	5962	0.00032
Segniliparus	286801	G	1212	47	1259	0.00007
Nocardioides	1839	G	403868	63948	467816	0.02529
Aeromicrobium	2040	G	29555	4322	33877	0.00183
Pimelobacter	2044	G	7789	2412	10201	0.00055
Marmoricola	86795	G	6767	2023	8790	0.00048
Friedmanniella	53387	G	5618	845	6463	0.00035
Mumia	1546255	G	4382	574	4956	0.00027
Micropruina	116071	G	2259	242	2501	0.00014
Microlunatus	29404	G	19698	1698	21396	0.00116
Tessaracoccus	72763	G	16970	7278	24248	0.00131
Brevilactibacter	2717325	G	6372	1769	8141	0.00044
Acidipropionibacterium	1912215	G	5376	1473	6849	0.00037
Propionibacterium	1743	G	5144	1372	6516	0.00035
Auraticoccus	1278221	G	3796	499	4295	0.00023
Cutibacterium	1912216	G	2488	387	2875	0.00016
Raineyella	1911549	G	2398	229	2627	0.00014
Arachnia	2801844	G	2349	122	2471	0.00013
Kribbella	182639	G	20536	2234	22770	0.00123
Actinopolymorpha	117156	G	9855	800	10655	0.00058
Actinomadura	1988	G	205529	28156	233685	0.01263
Thermomonospora	2019	G	12480	2474	14954	0.00081
Nonomuraea	83681	G	155381	20812	176193	0.00953
Streptosporangium	2000	G	29446	3860	33306	0.00180
Thermobispora	147067	G	5588	893	6481	0.00035
Nocardiopsis	2013	G	17660	2311	19971	0.00108
Thermobifida	83677	G	7434	1083	8517	0.00046
Streptomonospora	104204	G	3894	549	4443	0.00024
Spiractinospora	2913367	G	2715	127	2842	0.00015
Amycolatopsis	1813	G	135451	17626	153077	0.00828
Pseudonocardia	1847	G	121638	15541	137179	0.00742
Saccharothrix	2071	G	26801	5818	32619	0.00176
Saccharopolyspora	1835	G	23329	3436	26765	0.00145
Saccharomonospora	1851	G	15669	2217	17886	0.00097
Kutzneria	43356	G	15560	2429	17989	0.00097
Actinosynnema	40566	G	9451	2301	11752	0.00064
Actinoalloteichus	65496	G	9417	669	10086	0.00055
Lentzea	165301	G	7214	1159	8373	0.00045
Kibdelosporangium	2029	G	6365	583	6948	0.00038
Allokutzneria	1137960	G	6135	1105	7240	0.00039
Alloactinosynnema	674734	G	4638	778	5416	0.00029
Prauserella	142577	G	3292	232	3524	0.00019
Allosaccharopolyspora	2893576	G	2563	428	2991	0.00016
Blastococcus	38501	G	30243	6755	36998	0.00200
Modestobacter	88138	G	23468	5473	28941	0.00156
Geodermatophilus	1860	G	14529	3771	18300	0.00099
Nakamurella	53460	G	53839	6381	60220	0.00326
Actinomyces	1654	G	25920	2634	28554	0.00154
Schaalia	2529408	G	3499	486	3985	0.00022
Flaviflexus	1522056	G	1927	326	2253	0.00012
Trueperella	1069494	G	1714	371	2085	0.00011
Frankia	1854	G	30177	2121	32298	0.00175
Jiangella	281472	G	18053	2234	20287	0.00110
Bifidobacterium	1678	G	14276	3295	17571	0.00095
Catenulispora	414878	G	8797	896	9693	0.00052
Jatrophihabitans	1434010	G	5881	360	6241	0.00034
Stackebrandtia	283810	G	4380	279	4659	0.00025
Kineococcus	33981	G	4554	881	5435	0.00029
Epidermidibacterium	2078948	G	2705	912	3617	0.00020
Actinopolyspora	1849	G	2068	147	2215	0.00012
Acidothermus	28048	G	1426	50	1476	0.00008
Conexibacter	191494	G	91902	9540	101442	0.00548
Miltoncostaea	2843200	G	30431	2809	33240	0.00180
Aquihabitans	1648491	G	20267	2483	22750	0.00123
Iamia	467975	G	10322	1212	11534	0.00062
Actinomarinicola	2789775	G	9265	1348	10613	0.00057
Ilumatobacter	682522	G	4818	222	5040	0.00027
Acidimicrobium	53634	G	1482	86	1568	0.00008
Baekduia	2600304	G	29252	3500	32752	0.00177
Rubrobacter	42255	G	18324	545	18869	0.00102
Eggerthella	84111	G	3756	948	4704	0.00025
Gordonibacter	644652	G	2032	727	2759	0.00015
Adlercreutzia	447020	G	1614	276	1890	0.00010
Arabiibacter	2005386	G	1575	242	1817	0.00010
Olsenella	133925	G	2383	448	2831	0.00015
Parolsenella	2082587	G	1451	459	1910	0.00010
Collinsella	102106	G	2135	497	2632	0.00014
Egibacter	1747770	G	4488	186	4674	0.00025
Egicoccus	1755825	G	4361	473	4834	0.00026
Euzebya	908623	G	4330	250	4580	0.00025
Mesobacillus	2675231	G	73198	15605	88803	0.00480
Priestia	2800373	G	61113	49964	111077	0.00600
Bacillus	1386	G	41678	59600	101278	0.00548
Neobacillus	2675232	G	13893	4339	18232	0.00099
Cytobacillus	2675230	G	9531	2946	12477	0.00067
Metabacillus	2675233	G	4783	1339	6122	0.00033
Peribacillus	2675229	G	4647	1431	6078	0.00033
Geobacillus	129337	G	3906	993	4899	0.00026
Lysinibacillus	400634	G	3068	747	3815	0.00021
Anoxybacillus	150247	G	2863	602	3465	0.00019
Virgibacillus	84406	G	1991	196	2187	0.00012
Parageobacillus	1906945	G	1696	362	2058	0.00011
Niallia	2837506	G	1674	332	2006	0.00011
Hydrogenibacillus	1609627	G	1656	202	1858	0.00010
Rossellomorea	2837508	G	1512	447	1959	0.00011
Heyndrickxia	2837504	G	1381	344	1725	0.00009
Sutcliffiella	2837511	G	1362	339	1701	0.00009
Halobacillus	45667	G	1326	130	1456	0.00008
Alkalihalobacillus	2675234	G	1063	180	1243	0.00007
Paenibacillus	44249	G	85507	6604	92111	0.00498
Brevibacillus	55080	G	23402	3562	26964	0.00146
Cohnella	329857	G	6110	736	6846	0.00037
Thermobacillus	76632	G	2033	224	2257	0.00012
Saccharibacillus	456492	G	1606	146	1752	0.00009
Planococcus	1372	G	3662	873	4535	0.00025
Sporosarcina	1569	G	2191	462	2653	0.00014
Alicyclobacillus	29330	G	2984	172	3156	0.00017
Tumebacillus	432330	G	2095	563	2658	0.00014
Staphylococcus	1279	G	2645	2258	4903	0.00027
Exiguobacterium	33986	G	1959	452	2411	0.00013
Listeria	1637	G	1174	2121	3295	0.00018
Streptococcus	1301	G	2465	1300	3765	0.00020
Enterococcus	1350	G	1221	1078	2299	0.00012
Faecalibacterium	216851	G	2143	2162	4305	0.00023
Dysosmobacter	2591381	G	1153	548	1701	0.00009
Flavonifractor	946234	G	1039	274	1313	0.00007
Clostridium	1485	G	8260	4432	12692	0.00069
Thermaerobacter	73918	G	6175	439	6614	0.00036
Symbiobacterium	2733	G	2656	219	2875	0.00016
Desulfosporosinus	79206	G	1344	173	1517	0.00008
Christensenella	990721	G	1031	350	1381	0.00007
Moorella	44260	G	1137	126	1263	0.00007
Selenomonas	970	G	3380	145	3525	0.00019
Pelosinus	365348	G	1699	173	1872	0.00010
Limnochorda	1676651	G	2331	63	2394	0.00013
Oscillatoria	1158	G	76420	4723	81143	0.00439
Microcoleus	44471	G	35138	1675	36813	0.00199
Allocoleopsis	2886347	G	4109	116	4225	0.00023
Synechococcus	1129	G	14986	984	15970	0.00086
Cyanobium	167375	G	3126	468	3594	0.00019
Nostoc	1177	G	3684	1079	4763	0.00026
Calothrix	1186	G	1663	401	2064	0.00011
Leptolyngbya	47251	G	1937	115	2052	0.00011
Gloeobacter	33071	G	3825	71	3896	0.00021
Deinococcus	1298	G	31655	1208	32863	0.00178
Thermus	270	G	4509	247	4756	0.00026
Oceanithermus	208447	G	2494	185	2679	0.00014
Meiothermus	65551	G	2325	102	2427	0.00013
Marinithermus	186191	G	1451	191	1642	0.00009
Truepera	332248	G	2090	79	2169	0.00012
Sphaerobacter	2056	G	6800	370	7170	0.00039
Thermomicrobium	499	G	1608	29	1637	0.00009
Roseiflexus	120961	G	4433	240	4673	0.00025
Chloroflexus	1107	G	1527	61	1588	0.00009
Tepidiforma	2682228	G	3989	125	4114	0.00022
Candidatus Promineofilum	1988031	G	3628	53	3681	0.00020
Caldilinea	233191	G	2159	142	2301	0.00012
Ktedonosporobacter	2692417	G	1370	42	1412	0.00008
Fimbriimonas	1005038	G	2578	9	2587	0.00014
Urbifossiella	2807415	G	27669	1945	29614	0.00160
Gemmata	113	G	26155	1854	28009	0.00151
Frigoriglobus	2774146	G	13676	1847	15523	0.00084
Limnoglobus	2731450	G	9151	351	9502	0.00051
Tuwongella	2051044	G	1446	48	1494	0.00008
Telmatocola	1382832	G	1081	8	1089	0.00006
Lacipirellula	2691417	G	27701	1303	29004	0.00157
Pirellulimonas	2795783	G	4811	356	5167	0.00028
Botrimarina	2795782	G	4310	271	4581	0.00025
Aeoliella	2795781	G	1976	109	2085	0.00011
Adhaeretor	2862451	G	1078	72	1150	0.00006
Anatilimnocola	2807414	G	6152	552	6704	0.00036
Stieleria	2795973	G	4311	355	4666	0.00025
Rosistilla	2795779	G	4239	238	4477	0.00024
Lignipirellula	2795775	G	3960	367	4327	0.00023
Pirellula	123	G	3311	81	3392	0.00018
Bremerella	2714594	G	2886	164	3050	0.00016
Roseimaritima	1579506	G	2467	127	2594	0.00014
Rubripirellula	1579505	G	1155	174	1329	0.00007
Singulisphaera	466152	G	19814	2027	21841	0.00118
Paludisphaera	1763521	G	17924	2717	20641	0.00112
Aquisphaera	1511635	G	15127	1785	16912	0.00091
Tautonia	2680020	G	12361	744	13105	0.00071
Isosphaera	127	G	1605	82	1687	0.00009
Planctomyces	118	G	18532	3287	21819	0.00118
Gimesia	1649453	G	7113	334	7447	0.00040
Caulifigura	2795778	G	6618	359	6977	0.00038
Maioricimonas	2795777	G	3998	434	4432	0.00024
Alienimonas	2714737	G	3679	222	3901	0.00021
Symmachiella	2795780	G	2078	106	2184	0.00012
Planctopirus	1649480	G	1366	44	1410	0.00008
Fuerstiella	1936111	G	1269	18	1287	0.00007
Crateriforma	2714592	G	1104	162	1266	0.00007
Rubinisphaera	1649490	G	1094	93	1187	0.00006
Humisphaera	2807511	G	7519	150	7669	0.00041
Phycisphaera	666508	G	3663	245	3908	0.00021
Mucisphaera	2913022	G	1856	93	1949	0.00011
Opitutus	178440	G	28508	2262	30770	0.00166
Lacunisphaera	1961799	G	9995	1230	11225	0.00061
Nibricoccus	2576890	G	7914	301	8215	0.00044
Oleiharenicola	2100741	G	6034	273	6307	0.00034
Ereboglobus	2028344	G	3129	128	3257	0.00018
Ruficoccus	2175957	G	1094	115	1209	0.00007
Verrucomicrobium	2735	G	5978	405	6383	0.00035
Luteolibacter	518753	G	5210	181	5391	0.00029
Roseimicrobium	1348508	G	5020	175	5195	0.00028
Akkermansia	239934	G	1959	123	2082	0.00011
Methylacidimicrobium	1541670	G	1467	105	1572	0.00009
Kiritimatiella	1921784	G	1095	1077	2172	0.00012
Hymenobacter	89966	G	26079	1248	27327	0.00148
Pontibacter	323449	G	3527	414	3941	0.00021
Rufibacter	1379908	G	1063	294	1357	0.00007
Spirosoma	107	G	6345	326	6671	0.00036
Chryseolinea	1433993	G	5605	182	5787	0.00031
Fulvivirga	396811	G	1008	62	1070	0.00006
Dyadobacter	120831	G	2437	165	2602	0.00014
Fibrella	861914	G	1570	127	1697	0.00009
Runella	105	G	1177	48	1225	0.00007
Echinicola	390846	G	1010	257	1267	0.00007
Flavobacterium	237	G	12281	2587	14868	0.00080
Polaribacter	52959	G	1023	388	1411	0.00008
Chryseobacterium	59732	G	4435	1828	6263	0.00034
Chitinophaga	79328	G	5553	335	5888	0.00032
Panacibacter	1874621	G	4142	186	4328	0.00023
Niastella	354354	G	3352	345	3697	0.00020
Flavisolibacter	398041	G	3001	226	3227	0.00017
Lacibacter	649461	G	1968	89	2057	0.00011
Flavihumibacter	1004301	G	1674	93	1767	0.00010
Pseudocnuella	2812019	G	1380	164	1544	0.00008
Arachidicoccus	1769012	G	1332	212	1544	0.00008
Niabella	379899	G	1316	99	1415	0.00008
Paraflavitalea	2698688	G	1316	98	1414	0.00008
Ferruginibacter	1004303	G	1228	73	1301	0.00007
Pseudobacter	1860196	G	1145	97	1242	0.00007
Alistipes	239759	G	6368	2615	8983	0.00049
Prevotella	838	G	2933	396	3329	0.00018
Bacteroides	816	G	2722	1448	4170	0.00023
Mucilaginibacter	423349	G	9635	747	10382	0.00056
Pedobacter	84567	G	3635	264	3899	0.00021
Sphingobacterium	28453	G	2623	1380	4003	0.00022
Rhodocaloribacter	2893090	G	4352	358	4710	0.00025
Rhodothermus	29548	G	4002	169	4171	0.00023
Salinibacter	146918	G	2691	35	2726	0.00015
Chlorobaculum	256319	G	2258	245	2503	0.00014
Gemmatirosa	1706036	G	104991	7893	112884	0.00610
Gemmatimonas	173479	G	41831	1009	42840	0.00232
Luteitalea	2004797	G	58672	2312	60984	0.00330
Granulicella	940557	G	11036	919	11955	0.00065
Terriglobus	392733	G	7598	761	8359	0.00045
Edaphobacter	388463	G	7104	765	7869	0.00043
Acidobacterium	33973	G	5942	406	6348	0.00034
Candidatus Koribacter	658061	G	5566	153	5719	0.00031
Acidisarcina	2608728	G	2125	129	2254	0.00012
Paludibaculum	1649475	G	11348	262	11610	0.00063
Chloracidobacterium	458032	G	3397	86	3483	0.00019
Sulfidibacter	2915177	G	2218	29	2247	0.00012
Nitrospira	1234	G	13590	149	13739	0.00074
Treponema	157	G	1683	532	2215	0.00012
Fusarium	5506	G	38324	2007	40331	0.00218
Metarhizium	5529	G	7113	807	7920	0.00043
Ustilaginoidea	124426	G	1234	63	1297	0.00007
Trichoderma	5543	G	7953	328	8281	0.00045
Beauveria	5581	G	4061	142	4203	0.00023
Cordyceps	45234	G	1978	113	2091	0.00011
Purpureocillium	1052105	G	2156	138	2294	0.00012
Drechmeria	98402	G	1658	72	1730	0.00009
Colletotrichum	5455	G	2472	575	3047	0.00016
Thermothielavioides	2609811	G	2909	310	3219	0.00017
Thermothelomyces	1920207	G	2299	174	2473	0.00013
Neurospora	5140	G	1803	154	1957	0.00011
Pyricularia	48558	G	3073	31	3104	0.00017
Neopestalotiopsis	1562158	G	3750	70	3820	0.00021
Aspergillus	5052	G	2193	132	2325	0.00013
Penicillium	5073	G	1730	122	1852	0.00010
Paraphaeosphaeria	125369	G	1027	500	1527	0.00008
Pseudozyma	63298	G	3120	56	3176	0.00017
Sporisorium	63265	G	1049	310	1359	0.00007
Phytophthora	4783	G	9096	1420	10516	0.00057
