name	taxonomy_id	taxonomy_lvl	kraken_assigned_reads	added_reads	new_est_reads	fraction_total_reads
Streptomyces	1883	G	2111639	411245	2522884	0.12676
Kitasatospora	2063	G	35022	9859	44881	0.00226
Streptacidiphilus	228398	G	24008	5471	29479	0.00148
Yinghuangia	2805681	G	11145	1423	12568	0.00063
Microbacterium	33882	G	202625	27661	230286	0.01157
Agromyces	33877	G	70801	13189	83990	0.00422
Leifsonia	110932	G	43610	28447	72057	0.00362
Curtobacterium	2034	G	41984	6860	48844	0.00245
Rathayibacter	33886	G	35962	6403	42365	0.00213
Clavibacter	1573	G	28110	13662	41772	0.00210
Leucobacter	55968	G	26640	3906	30546	0.00153
Agrococcus	46352	G	25971	5502	31473	0.00158
Protaetiibacter	2680004	G	17515	3961	21476	0.00108
Salinibacterium	235888	G	10905	1384	12289	0.00062
Cryobacterium	69578	G	9699	1070	10769	0.00054
Frondihabitans	447237	G	8220	996	9216	0.00046
Microterricola	518733	G	7168	1357	8525	0.00043
Plantibacter	190323	G	7015	679	7694	0.00039
Microcella	337004	G	6798	1860	8658	0.00044
Cnuibacter	1759331	G	5083	847	5930	0.00030
Gryllotalpicola	1195526	G	5003	747	5750	0.00029
Herbiconiux	881616	G	4988	767	5755	0.00029
Frigoribacterium	96492	G	4665	1053	5718	0.00029
Mycetocola	76634	G	4316	422	4738	0.00024
Subtercola	120212	G	4225	272	4497	0.00023
Humibacter	427753	G	4003	686	4689	0.00024
Amnibacterium	1029631	G	3677	682	4359	0.00022
Chryseoglobus	1331730	G	3605	555	4160	0.00021
Gulosibacter	256818	G	2842	639	3481	0.00017
Marisediminicola	1230698	G	2792	267	3059	0.00015
Diaminobutyricimonas	1433997	G	2634	381	3015	0.00015
Glaciihabitans	1649454	G	2216	135	2351	0.00012
Agreia	110934	G	2159	200	2359	0.00012
Arthrobacter	1663	G	288943	59385	348328	0.01750
Sinomonas	596707	G	49201	10087	59288	0.00298
Pseudarthrobacter	1742993	G	47673	13538	61211	0.00308
Kocuria	57493	G	26192	6205	32397	0.00163
Micrococcus	1269	G	12050	6842	18892	0.00095
Glutamicibacter	1742989	G	8436	2220	10656	0.00054
Paenarthrobacter	1742992	G	7599	3150	10749	0.00054
Rothia	32207	G	5035	1674	6709	0.00034
Citricoccus	169133	G	4368	897	5265	0.00026
Nesterenkonia	57494	G	1351	68	1419	0.00007
Intrasporangium	53357	G	29136	6358	35494	0.00178
Janibacter	53457	G	26304	6591	32895	0.00165
Phycicoccus	367298	G	24340	6206	30546	0.00153
Pedococcus	2805645	G	20366	5645	26011	0.00131
Tetrasphaera	99479	G	15551	3810	19361	0.00097
Arsenicicoccus	267408	G	8121	2677	10798	0.00054
Cellulomonas	1707	G	96115	27703	123818	0.00622
Actinotalea	458839	G	6265	1912	8177	0.00041
Oerskovia	162491	G	4963	1339	6302	0.00032
Pseudactinotalea	1926259	G	4230	515	4745	0.00024
Paraoerskovia	665568	G	3307	725	4032	0.00020
Cellulosimicrobium	157920	G	38182	14216	52398	0.00263
Xylanimonas	186188	G	15535	4223	19758	0.00099
Isoptericola	254250	G	11783	4448	16231	0.00082
Ornithinimicrobium	125287	G	26494	4806	31300	0.00157
Serinicoccus	265976	G	20030	4755	24785	0.00125
Brachybacterium	43668	G	29317	4031	33348	0.00168
Dermabacter	36739	G	2036	948	2984	0.00015
Brevibacterium	1696	G	30623	5183	35806	0.00180
Dermacoccus	57495	G	9310	2758	12068	0.00061
Luteipulveratus	745364	G	6921	838	7759	0.00039
Allobranchiibius	2040262	G	5660	1075	6735	0.00034
Yimella	908935	G	3297	566	3863	0.00019
Georgenia	154116	G	23584	5766	29350	0.00147
Ruania	626119	G	18774	1879	20653	0.00104
Pengzhenrongella	2888818	G	7250	1685	8935	0.00045
Luteimicrobium	754249	G	6590	1699	8289	0.00042
Beutenbergia	84756	G	7719	1075	8794	0.00044
Miniimonas	947525	G	5304	2316	7620	0.00038
Sanguibacter	60919	G	9197	2318	11515	0.00058
Gephyromycinifex	2885697	G	2132	213	2345	0.00012
Austwickia	1184606	G	1593	106	1699	0.00009
Kytococcus	57499	G	4098	1229	5327	0.00027
Demequina	577469	G	1358	88	1446	0.00007
Nocardioides	1839	G	842550	156243	998793	0.05018
Aeromicrobium	2040	G	43649	7221	50870	0.00256
Marmoricola	86795	G	13542	4388	17930	0.00090
Pimelobacter	2044	G	11255	3638	14893	0.00075
Friedmanniella	53387	G	9366	1573	10939	0.00055
Mumia	1546255	G	6897	1023	7920	0.00040
Micropruina	116071	G	3249	393	3642	0.00018
Microlunatus	29404	G	30752	2984	33736	0.00170
Tessaracoccus	72763	G	24130	4153	28283	0.00142
Brevilactibacter	2717325	G	9386	3150	12536	0.00063
Acidipropionibacterium	1912215	G	7661	2567	10228	0.00051
Propionibacterium	1743	G	7505	2166	9671	0.00049
Auraticoccus	1278221	G	6042	915	6957	0.00035
Raineyella	1911549	G	3697	410	4107	0.00021
Arachnia	2801844	G	3474	216	3690	0.00019
Cutibacterium	1912216	G	3447	593	4040	0.00020
Kribbella	182639	G	64810	7991	72801	0.00366
Actinopolymorpha	117156	G	11288	1054	12342	0.00062
Mycobacterium	1763	G	228442	51665	280107	0.01407
Mycolicibacterium	1866885	G	217723	34430	252153	0.01267
Mycolicibacter	1073531	G	14784	5155	19939	0.00100
Mycobacteroides	670516	G	11813	3097	14910	0.00075
Mycolicibacillus	2126281	G	2996	671	3667	0.00018
Hoyosella	697025	G	1307	56	1363	0.00007
Nocardia	1817	G	141920	20086	162006	0.00814
Rhodococcus	1827	G	133912	30682	164594	0.00827
Corynebacterium	1716	G	80455	16589	97044	0.00488
Gordonia	2053	G	64897	11740	76637	0.00385
Skermania	59613	G	3020	278	3298	0.00017
Tsukamurella	2060	G	21748	4477	26225	0.00132
Dietzia	37914	G	12556	2512	15068	0.00076
Tomitella	741759	G	7503	1259	8762	0.00044
Segniliparus	286801	G	1807	81	1888	0.00009
Micromonospora	1873	G	302329	66383	368712	0.01853
Actinoplanes	1865	G	214663	31738	246401	0.01238
Couchioplanes	56433	G	74828	15686	90514	0.00455
Dactylosporangium	35753	G	57715	5308	63023	0.00317
Phytohabitans	907364	G	35008	3853	38861	0.00195
Plantactinospora	673534	G	25799	3919	29718	0.00149
Actinocatenispora	390988	G	23326	2406	25732	0.00129
Catellatospora	53365	G	19217	3494	22711	0.00114
Polymorphospora	338583	G	12261	2231	14492	0.00073
Natronosporangium	2920401	G	6605	372	6977	0.00035
Verrucosispora	84593	G	5241	3327	8568	0.00043
Salinispora	168694	G	3912	539	4451	0.00022
Amycolatopsis	1813	G	255847	40906	296753	0.01491
Pseudonocardia	1847	G	182593	27669	210262	0.01056
Saccharothrix	2071	G	53064	12779	65843	0.00331
Saccharopolyspora	1835	G	38311	6564	44875	0.00225
Kutzneria	43356	G	24622	4306	28928	0.00145
Saccharomonospora	1851	G	23568	3631	27199	0.00137
Actinosynnema	40566	G	14371	3900	18271	0.00092
Actinoalloteichus	65496	G	13783	1090	14873	0.00075
Lentzea	165301	G	11871	2113	13984	0.00070
Kibdelosporangium	2029	G	10033	1023	11056	0.00056
Allokutzneria	1137960	G	9567	1931	11498	0.00058
Alloactinosynnema	674734	G	7742	1447	9189	0.00046
Prauserella	142577	G	5001	386	5387	0.00027
Allosaccharopolyspora	2893576	G	4068	747	4815	0.00024
Actinomadura	1988	G	181742	29568	211310	0.01062
Thermomonospora	2019	G	17974	4362	22336	0.00112
Nonomuraea	83681	G	95047	13854	108901	0.00547
Streptosporangium	2000	G	39157	6458	45615	0.00229
Thermobispora	147067	G	8043	1508	9551	0.00048
Nocardiopsis	2013	G	25962	4096	30058	0.00151
Thermobifida	83677	G	11286	1926	13212	0.00066
Streptomonospora	104204	G	6053	992	7045	0.00035
Spiractinospora	2913367	G	3997	220	4217	0.00021
Blastococcus	38501	G	68380	17614	85994	0.00432
Modestobacter	88138	G	50767	13671	64438	0.00324
Geodermatophilus	1860	G	32934	9812	42746	0.00215
Actinomyces	1654	G	36516	4147	40663	0.00204
Schaalia	2529408	G	4564	635	5199	0.00026
Flaviflexus	1522056	G	2854	552	3406	0.00017
Trueperella	1069494	G	2304	544	2848	0.00014
Pauljensenia	2740557	G	1350	373	1723	0.00009
Nanchangia	2888879	G	1107	97	1204	0.00006
Frankia	1854	G	48553	3909	52462	0.00264
Jiangella	281472	G	28264	4058	32322	0.00162
Nakamurella	53460	G	26742	3142	29884	0.00150
Bifidobacterium	1678	G	19405	3907	23312	0.00117
Catenulispora	414878	G	16199	1937	18136	0.00091
Jatrophihabitans	1434010	G	10834	775	11609	0.00058
Stackebrandtia	283810	G	6222	470	6692	0.00034
Kineococcus	33981	G	6944	1576	8520	0.00043
Epidermidibacterium	2078948	G	4111	1638	5749	0.00029
Actinopolyspora	1849	G	3193	267	3460	0.00017
Acidothermus	28048	G	2173	88	2261	0.00011
Conexibacter	191494	G	197210	23910	221120	0.01111
Miltoncostaea	2843200	G	48884	5245	54129	0.00272
Baekduia	2600304	G	76030	10630	86660	0.00435
Rubrobacter	42255	G	31916	1096	33012	0.00166
Aquihabitans	1648491	G	25351	3548	28899	0.00145
Iamia	467975	G	11692	1567	13259	0.00067
Actinomarinicola	2789775	G	11579	1921	13500	0.00068
Ilumatobacter	682522	G	6008	316	6324	0.00032
Acidimicrobium	53634	G	2372	156	2528	0.00013
Eggerthella	84111	G	5031	1467	6498	0.00033
Gordonibacter	644652	G	2503	926	3429	0.00017
Arabiibacter	2005386	G	2248	377	2625	0.00013
Adlercreutzia	447020	G	2194	403	2597	0.00013
Raoultibacter	1926677	G	1147	76	1223	0.00006
Olsenella	133925	G	3386	544	3930	0.00020
Parolsenella	2082587	G	1942	587	2529	0.00013
Parafannyhessea	2847312	G	1179	584	1763	0.00009
Thermophilibacter	2847307	G	1160	368	1528	0.00008
Collinsella	102106	G	2984	771	3755	0.00019
Egibacter	1747770	G	7445	365	7810	0.00039
Egicoccus	1755825	G	6529	837	7366	0.00037
Euzebya	908623	G	6332	434	6766	0.00034
Priestia	2800373	G	61953	47911	109864	0.00552
Bacillus	1386	G	29020	54854	83874	0.00421
Mesobacillus	2675231	G	12945	3029	15974	0.00080
Neobacillus	2675232	G	11197	3859	15056	0.00076
Geobacillus	129337	G	3851	991	4842	0.00024
Cytobacillus	2675230	G	3195	1011	4206	0.00021
Peribacillus	2675229	G	2758	928	3686	0.00019
Hydrogenibacillus	1609627	G	2536	306	2842	0.00014
Metabacillus	2675233	G	2425	740	3165	0.00016
Lysinibacillus	400634	G	2223	528	2751	0.00014
Anoxybacillus	150247	G	2062	419	2481	0.00012
Parageobacillus	1906945	G	1162	245	1407	0.00007
Paenibacillus	44249	G	67890	6004	73894	0.00371
Brevibacillus	55080	G	10032	1563	11595	0.00058
Cohnella	329857	G	4356	550	4906	0.00025
Thermobacillus	76632	G	2299	262	2561	0.00013
Saccharibacillus	456492	G	1795	176	1971	0.00010
Alicyclobacillus	29330	G	3647	226	3873	0.00019
Tumebacillus	432330	G	2482	707	3189	0.00016
Kyrpidia	1129704	G	1046	43	1089	0.00005
Planococcus	1372	G	2397	642	3039	0.00015
Sporosarcina	1569	G	1224	278	1502	0.00008
Staphylococcus	1279	G	1647	7327	8974	0.00045
Exiguobacterium	33986	G	1872	446	2318	0.00012
Streptococcus	1301	G	1912	1663	3575	0.00018
Faecalibacterium	216851	G	2533	1914	4447	0.00022
Dysosmobacter	2591381	G	1557	864	2421	0.00012
Flavonifractor	946234	G	1334	419	1753	0.00009
Thermaerobacter	73918	G	8851	681	9532	0.00048
Clostridium	1485	G	9586	1710	11296	0.00057
Symbiobacterium	2733	G	3647	325	3972	0.00020
Desulfosporosinus	79206	G	1678	200	1878	0.00009
Christensenella	990721	G	1264	505	1769	0.00009
Moorella	44260	G	1552	125	1677	0.00008
Gelria	189326	G	1251	132	1383	0.00007
Selenomonas	970	G	4308	193	4501	0.00023
Pelosinus	365348	G	1265	138	1403	0.00007
Megasphaera	906	G	1135	339	1474	0.00007
Limnochorda	1676651	G	3444	106	3550	0.00018
Deinococcus	1298	G	40787	1677	42464	0.00213
Thermus	270	G	6037	373	6410	0.00032
Oceanithermus	208447	G	3267	266	3533	0.00018
Meiothermus	65551	G	3031	146	3177	0.00016
Marinithermus	186191	G	2011	279	2290	0.00012
Truepera	332248	G	2946	123	3069	0.00015
Synechococcus	1129	G	18429	2018	20447	0.00103
Cyanobium	167375	G	4058	848	4906	0.00025
Nostoc	1177	G	2950	1234	4184	0.00021
Calothrix	1186	G	1554	499	2053	0.00010
Gloeobacter	33071	G	4859	146	5005	0.00025
Leptolyngbya	47251	G	2271	230	2501	0.00013
Sphaerobacter	2056	G	10363	569	10932	0.00055
Thermomicrobium	499	G	2194	43	2237	0.00011
Roseiflexus	120961	G	6458	324	6782	0.00034
Chloroflexus	1107	G	2162	78	2240	0.00011
Tepidiforma	2682228	G	5736	192	5928	0.00030
Candidatus Promineofilum	1988031	G	5083	80	5163	0.00026
Caldilinea	233191	G	2556	157	2713	0.00014
Ktedonosporobacter	2692417	G	2477	72	2549	0.00013
Dehalogenimonas	670486	G	1051	64	1115	0.00006
Thermobaculum	262406	G	1212	136	1348	0.00007
Fimbriimonas	1005038	G	2990	12	3002	0.00015
Bradyrhizobium	374	G	804811	85716	890527	0.04474
Rhodopseudomonas	1073	G	46994	10915	57909	0.00291
Tardiphaga	1395974	G	24834	2508	27342	0.00137
Nitrobacter	911	G	21853	2242	24095	0.00121
Afipia	1033	G	20532	5967	26499	0.00133
Variibacter	1649510	G	10058	597	10655	0.00054
Mesorhizobium	68287	G	226847	33785	260632	0.01310
Aquibium	2911176	G	10941	2001	12942	0.00065
Aminobacter	31988	G	9056	4423	13479	0.00068
Nitratireductor	245876	G	7461	849	8310	0.00042
Phyllobacterium	28100	G	4823	372	5195	0.00026
Roseitalea	1915401	G	3594	461	4055	0.00020
Hoeflea	274591	G	2874	206	3080	0.00015
Oricola	1594166	G	2565	266	2831	0.00014
Rhizobium	379	G	100741	31966	132707	0.00667
Agrobacterium	357	G	21880	6458	28338	0.00142
Neorhizobium	1525371	G	10548	1942	12490	0.00063
Pseudorhizobium	1903858	G	2939	447	3386	0.00017
Sinorhizobium	28105	G	22645	7703	30348	0.00152
Ensifer	106591	G	20739	3277	24016	0.00121
Shinella	323620	G	18521	10213	28734	0.00144
Ciceribacter	1648508	G	2532	395	2927	0.00015
Georhizobium	2661800	G	2165	365	2530	0.00013
Methylobacterium	407	G	111887	16085	127972	0.00643
Microvirga	186650	G	46595	4298	50893	0.00256
Methylorubrum	2282523	G	24529	8075	32604	0.00164
Rhodoplanes	29407	G	125243	9514	134757	0.00677
Hyphomicrobium	81	G	34654	1570	36224	0.00182
Methyloceanibacter	1484898	G	6510	321	6831	0.00034
Aquabacter	45402	G	4333	564	4897	0.00025
Methyloligella	1485594	G	4242	384	4626	0.00023
Rhodomicrobium	1068	G	3048	154	3202	0.00016
Caenibius	2827482	G	2735	959	3694	0.00019
Filomicrobium	119044	G	1355	27	1382	0.00007
Pseudolabrys	556257	G	84853	10009	94862	0.00477
Starkeya	152053	G	17994	3865	21859	0.00110
Labrys	204476	G	16974	1374	18348	0.00092
Xanthobacter	279	G	15099	2883	17982	0.00090
Ancylobacter	99	G	15022	4305	19327	0.00097
Azorhizobium	6	G	5063	866	5929	0.00030
Bosea	85413	G	92871	12186	105057	0.00528
Devosia	46913	G	36607	2417	39024	0.00196
Youhaiella	1827478	G	3716	744	4460	0.00022
Paradevosia	1573407	G	3673	1156	4829	0.00024
Pelagibacterium	1082930	G	1790	210	2000	0.00010
Aureimonas	414371	G	19928	3185	23113	0.00116
Martelella	293088	G	10725	1716	12441	0.00063
Aurantimonas	182269	G	5306	1258	6564	0.00033
Methylocystis	133	G	18461	1311	19772	0.00099
Methylosinus	425	G	8924	1083	10007	0.00050
Pseudorhodoplanes	1734920	G	14452	840	15292	0.00077
Nordella	169055	G	9531	418	9949	0.00050
Terrihabitans	2874214	G	3534	319	3853	0.00019
Phreatobacter	1632780	G	22081	2931	25012	0.00126
Stappia	152161	G	8320	1230	9550	0.00048
Roseibium	150830	G	4106	422	4528	0.00023
Pannonibacter	227873	G	3905	2187	6092	0.00031
Labrenzia	478070	G	3304	233	3537	0.00018
Methylocella	120652	G	6716	498	7214	0.00036
Methylovirgula	1156568	G	5559	370	5929	0.00030
Beijerinckia	532	G	1511	97	1608	0.00008
Blastochloris	59282	G	13507	2506	16013	0.00080
Kaustia	2838250	G	6263	480	6743	0.00034
Parvibaculum	256616	G	3190	1664	4854	0.00024
Pyruvatibacter	1742974	G	2234	232	2466	0.00012
Chelatococcus	28209	G	11853	2095	13948	0.00070
Kaistia	166953	G	8115	1573	9688	0.00049
Brucella	234	G	6710	3232	9942	0.00050
Pseudochrobactrum	354349	G	1315	223	1538	0.00008
Acuticoccus	1904377	G	7129	601	7730	0.00039
Hartmannibacter	1572860	G	4467	628	5095	0.00026
Lichenihabitans	2723776	G	4335	157	4492	0.00023
Breoghania	1406135	G	4259	441	4700	0.00024
Sphingomonas	13687	G	250732	25931	276663	0.01390
Sphingobium	165695	G	109755	54460	164215	0.00825
Sphingopyxis	165697	G	50030	7517	57547	0.00289
Novosphingobium	165696	G	41963	11086	53049	0.00267
Rhizorhabdus	1649486	G	15966	5368	21334	0.00107
Sphingosinithalassobacter	2676233	G	6895	1232	8127	0.00041
Allosphingosinicella	2823232	G	4301	382	4683	0.00024
Parasphingopyxis	1234545	G	3709	135	3844	0.00019
Blastomonas	150203	G	3475	453	3928	0.00020
Sphingorhabdus	1434046	G	3427	160	3587	0.00018
Tardibacter	2685927	G	2929	1501	4430	0.00022
Hankyongella	1763827	G	2449	339	2788	0.00014
Citromicrobium	72173	G	2284	789	3073	0.00015
Novosphingopyxis	2709686	G	1612	675	2287	0.00011
Parasphingorhabdus	2709685	G	1000	22	1022	0.00005
Erythrobacter	1041	G	24773	5125	29898	0.00150
Porphyrobacter	1111	G	7643	1661	9304	0.00047
Qipengyuania	1855416	G	14956	3184	18140	0.00091
Tsuneonella	2800686	G	9858	1536	11394	0.00057
Altererythrobacter	361177	G	9709	2081	11790	0.00059
Croceicoccus	1295327	G	9011	4456	13467	0.00068
Croceibacterium	2676755	G	1828	637	2465	0.00012
Aurantiacibacter	2800681	G	1807	247	2054	0.00010
Pelagerythrobacter	2800685	G	1726	190	1916	0.00010
Paraurantiacibacter	2800682	G	1474	150	1624	0.00008
Sphingosinicella	335405	G	10763	878	11641	0.00058
Polymorphobacter	1508451	G	6651	209	6860	0.00034
Sandaracinobacter	56358	G	2638	142	2780	0.00014
Azospirillum	191	G	66803	6549	73352	0.00369
Skermanella	204447	G	21374	2327	23701	0.00119
Nitrospirillum	1543705	G	5366	464	5830	0.00029
Indioceanicola	2478349	G	3536	362	3898	0.00020
Niveispirillum	1543704	G	2188	180	2368	0.00012
Roseomonas	125216	G	38860	4212	43072	0.00216
Rhodovastum	504465	G	8455	608	9063	0.00046
Komagataeibacter	1434011	G	6655	2262	8917	0.00045
Acidiphilium	522	G	5669	2217	7886	0.00040
Roseococcus	35812	G	4944	329	5273	0.00026
Sediminicoccus	1706033	G	4197	155	4352	0.00022
Acidibrevibacterium	2603324	G	4070	267	4337	0.00022
Lichenicola	2804525	G	3831	133	3964	0.00020
Acetobacter	434	G	3657	1010	4667	0.00023
Gluconobacter	441	G	2658	501	3159	0.00016
Gluconacetobacter	89583	G	2554	382	2936	0.00015
Granulibacter	364409	G	1641	104	1745	0.00009
Asaia	91914	G	1146	139	1285	0.00006
Neoasaia	320496	G	1133	164	1297	0.00007
Hypericibacter	2705399	G	23320	1060	24380	0.00122
Magnetospirillum	13134	G	12600	189699	202299	0.01016
Rhodospirillum	1081	G	7638	653	8291	0.00042
Tistrella	171436	G	5533	1791	7324	0.00037
Ferrovibrio	1231242	G	4409	212	4621	0.00023
Defluviicoccus	111830	G	2747	187	2934	0.00015
Pararhodospirillum	1612157	G	1710	95	1805	0.00009
Stella	93	G	11049	576	11625	0.00058
Elioraea	457933	G	5259	196	5455	0.00027
Thalassospira	168934	G	2193	138	2331	0.00012
Magnetospira	1182780	G	1201	29	1230	0.00006
Paracoccus	265	G	38590	5422	44012	0.00221
Cereibacter	1653176	G	10090	1875	11965	0.00060
Rhodobacter	1060	G	9995	2434	12429	0.00062
Rhodovulum	34008	G	5736	1052	6788	0.00034
Polymorphum	991903	G	4669	913	5582	0.00028
Paroceanicella	2683599	G	4270	899	5169	0.00026
Thioclava	285107	G	3288	331	3619	0.00018
Pikeienuella	2831955	G	2981	227	3208	0.00016
Pontivivens	1844015	G	2908	172	3080	0.00015
Pelagovum	2795377	G	2476	247	2723	0.00014
Silicimonas	1955420	G	2351	111	2462	0.00012
Frigidibacter	1775705	G	2057	682	2739	0.00014
Pukyongiella	2831925	G	2025	396	2421	0.00012
Brevirhabdus	1855413	G	1820	697	2517	0.00013
Gymnodinialimonas	2937410	G	1587	120	1707	0.00009
Fuscovulum	2818469	G	1530	152	1682	0.00008
Haematobacter	366614	G	1356	434	1790	0.00009
Falsirhodobacter	1434002	G	1328	149	1477	0.00007
Pacificitalea	2846749	G	1319	235	1554	0.00008
Pseudopuniceibacterium	2613960	G	1281	80	1361	0.00007
Gemmobacter	204456	G	1276	197	1473	0.00007
Tabrizicola	1443919	G	1192	83	1275	0.00006
Pseudooceanicola	1679449	G	1123	88	1211	0.00006
Monaibacterium	2029873	G	1019	193	1212	0.00006
Roseicitreum	1209946	G	1016	42	1058	0.00005
Roseovarius	74030	G	10197	1259	11456	0.00058
Sulfitobacter	60136	G	9855	1498	11353	0.00057
Salipiger	263377	G	7922	2049	9971	0.00050
Roseivivax	93682	G	6229	759	6988	0.00035
Celeribacter	875170	G	4333	1321	5654	0.00028
Phaeobacter	302485	G	3845	583	4428	0.00022
Ruegeria	97050	G	3460	392	3852	0.00019
Leisingera	191028	G	3457	369	3826	0.00019
Pseudosulfitobacter	2854186	G	2845	628	3473	0.00017
Yangia	2919626	G	2761	365	3126	0.00016
Sagittula	58842	G	2563	836	3399	0.00017
Ponticoccus	983507	G	2043	243	2286	0.00011
Mameliella	1434019	G	1970	289	2259	0.00011
Dinoroseobacter	309512	G	1712	494	2206	0.00011
Roseobacter	2433	G	1705	38	1743	0.00009
Ketogulonicigenium	92944	G	1587	143	1730	0.00009
Octadecabacter	53945	G	1543	84	1627	0.00008
Actibacterium	1433986	G	1484	578	2062	0.00010
Roseibacterium	159345	G	1400	93	1493	0.00008
Oceanicola	252301	G	1336	54	1390	0.00007
Caulobacter	75	G	62184	5872	68056	0.00342
Brevundimonas	41275	G	42830	5100	47930	0.00241
Phenylobacterium	20	G	19908	2685	22593	0.00114
Asticcacaulis	76890	G	3829	238	4067	0.00020
Terricaulis	2768684	G	2560	68	2628	0.00013
Marinicauda	1649466	G	3335	443	3778	0.00019
Maricaulis	74317	G	1214	60	1274	0.00006
Glycocaulis	1433402	G	1180	48	1228	0.00006
Hyphomonas	85	G	3964	143	4107	0.00021
Candidatus Viadribacter	2892997	G	1475	30	1505	0.00008
Aquisalinus	1795639	G	1462	57	1519	0.00008
Burkholderia	32008	G	212570	137309	349879	0.01758
Cupriavidus	106589	G	170004	49969	219973	0.01105
Paraburkholderia	1822464	G	96753	7748	104501	0.00525
Ralstonia	48736	G	34121	15024	49145	0.00247
Pandoraea	93217	G	31792	4879	36671	0.00184
Caballeronia	1827195	G	28226	2775	31001	0.00156
Polynucleobacter	44013	G	2816	56	2872	0.00014
Lautropia	47670	G	1739	234	1973	0.00010
Chitinimonas	240411	G	1629	97	1726	0.00009
Mycetohabitans	2571159	G	1336	65	1401	0.00007
Variovorax	34072	G	107858	28868	136726	0.00687
Hydrogenophaga	47420	G	40540	14295	54835	0.00276
Acidovorax	12916	G	39761	16322	56083	0.00282
Ramlibacter	174951	G	28583	9145	37728	0.00190
Rhodoferax	28065	G	24073	5260	29333	0.00147
Comamonas	283	G	23649	9522	33171	0.00167
Polaromonas	52972	G	14154	1016	15170	0.00076
Diaphorobacter	238749	G	12607	10244	22851	0.00115
Delftia	80865	G	11654	9905	21559	0.00108
Schlegelella	215579	G	11627	2723	14350	0.00072
Kinneretia	683756	G	7989	3718	11707	0.00059
Ottowia	219181	G	6667	944	7611	0.00038
Alicycliphilus	201096	G	6014	8395	14409	0.00072
Melaminivora	1649468	G	5218	3786	9004	0.00045
Serpentinimonas	2490452	G	3240	591	3831	0.00019
Verminephrobacter	364316	G	2899	292	3191	0.00016
Hylemonella	232523	G	2461	286	2747	0.00014
Pulveribacter	2678886	G	2382	1035	3417	0.00017
Simplicispira	352450	G	1755	528	2283	0.00011
Limnohabitans	665874	G	1226	96	1322	0.00007
Massilia	149698	G	99415	13860	113275	0.00569
Duganella	75654	G	8857	2393	11250	0.00057
Herbaspirillum	963	G	18950	2779	21729	0.00109
Janthinobacterium	29580	G	18324	4078	22402	0.00113
Collimonas	202907	G	8779	799	9578	0.00048
Noviherbaspirillum	1344552	G	5629	749	6378	0.00032
Undibacterium	401469	G	1229	60	1289	0.00006
Achromobacter	222	G	57562	18177	75739	0.00381
Bordetella	517	G	46662	56645	103307	0.00519
Pigmentiphaga	152267	G	7357	609	7966	0.00040
Orrella	1921582	G	3566	807	4373	0.00022
Castellaniella	359336	G	3488	1776	5264	0.00026
Alcaligenes	507	G	2526	462	2988	0.00015
Paralcaligenes	1148163	G	1984	58	2042	0.00010
Pusillimonas (ex Stolz et al. 2005)	305976	G	1653	227	1880	0.00009
Advenella	290425	G	1014	22	1036	0.00005
Kerstersia	257820	G	1012	156	1168	0.00006
Rhizobacter	212743	G	15162	2625	17787	0.00089
Sphaerotilus	34102	G	10270	4021	14291	0.00072
Methylibium	316612	G	9284	2403	11687	0.00059
Rubrivivax	28067	G	8064	2004	10068	0.00051
Thiomonas	32012	G	6927	619	7546	0.00038
Aquincola	391952	G	6117	1671	7788	0.00039
Mitsuaria	65047	G	5730	905	6635	0.00033
Leptothrix	88	G	5473	1388	6861	0.00034
Xylophilus	54066	G	4814	1087	5901	0.00030
Ideonella	36862	G	3353	1574	4927	0.00025
Tepidimonas	114248	G	2953	833	3786	0.00019
Aquabacterium	92793	G	2667	554	3221	0.00016
Roseateles	93681	G	2601	395	2996	0.00015
Inhella	644355	G	1879	235	2114	0.00011
Paucibacter	318147	G	1636	219	1855	0.00009
Sutterella	40544	G	2290	159	2449	0.00012
Thauera	33057	G	19838	9812	29650	0.00149
Azoarcus	12960	G	17072	4386	21458	0.00108
Nitrogeniibacter	2891294	G	5447	677	6124	0.00031
Aromatoleum	551759	G	16035	3806	19841	0.00100
Azospira	146937	G	10659	3852	14511	0.00073
Niveibacterium	1769726	G	2941	329	3270	0.00016
Oryzomicrobium	1911577	G	2203	462	2665	0.00013
Dechloromonas	73029	G	5021	721	5742	0.00029
Ferribacterium	88875	G	4147	587	4734	0.00024
Quatrionicoccus	138117	G	1814	455	2269	0.00011
Usitatibacter	2803845	G	25584	1596	27180	0.00137
Nitrosospira	35798	G	9493	258	9751	0.00049
Nitrosomonas	914	G	7804	330	8134	0.00041
Denitratisoma	311181	G	4336	1669	6005	0.00030
Sulfuritalea	1054211	G	3438	435	3873	0.00019
Methyloversatilis	378210	G	3219	344	3563	0.00018
Sterolibacterium	157591	G	2385	526	2911	0.00015
Sideroxydans	314343	G	3392	419	3811	0.00019
Ferrigenium	2249462	G	2195	414	2609	0.00013
Thiobacillus	919	G	4484	701	5185	0.00026
Sulfuritortus	1938335	G	2934	992	3926	0.00020
Sulfuriferula	1778653	G	2783	364	3147	0.00016
Sulfurimicrobium	2772198	G	2437	281	2718	0.00014
Sulfuricella	935200	G	1255	107	1362	0.00007
Methylovorus	81682	G	1686	269	1955	0.00010
Chromobacterium	535	G	17109	3069	20178	0.00101
Jeongeupia	885864	G	4995	706	5701	0.00029
Paludibacterium	400060	G	4086	539	4625	0.00023
Pseudogulbenkiania	568394	G	4042	1056	5098	0.00026
Vogesella	57739	G	2886	559	3445	0.00017
Aquitalea	407217	G	2475	380	2855	0.00014
Microvirgula	57479	G	2067	303	2370	0.00012
Laribacter	168470	G	1464	1007	2471	0.00012
Aquaspirillum	187	G	1024	116	1140	0.00006
Neisseria	482	G	5923	1805	7728	0.00039
Crenobacter	1654931	G	3292	832	4124	0.00021
Chitinolyticbacter	1055692	G	2157	203	2360	0.00012
Vitreoscilla	59	G	1200	153	1353	0.00007
Casimicrobium	2706000	G	2440	868	3308	0.00017
Lysobacter	68	G	113826	14931	128757	0.00647
Stenotrophomonas	40323	G	53602	18986	72588	0.00365
Xanthomonas	338	G	51672	25730	77402	0.00389
Luteimonas	83614	G	31708	5275	36983	0.00186
Pseudoxanthomonas	83618	G	23249	8352	31601	0.00159
Thermomonas	141948	G	16262	3764	20026	0.00101
Arenimonas	490567	G	5771	939	6710	0.00034
Pseudolysobacter	2709666	G	2778	57	2835	0.00014
Rhodanobacter	75309	G	21214	3809	25023	0.00126
Luteibacter	242605	G	19770	1725	21495	0.00108
Frateuria	70411	G	18061	3827	21888	0.00110
Dyella	231454	G	17396	2601	19997	0.00100
Dokdonella	323413	G	8823	1214	10037	0.00050
Aerosticca	2707020	G	3678	3605	7283	0.00037
Ahniella	2233801	G	1689	33	1722	0.00009
Pseudomonas	286	G	330772	123072	453844	0.02280
Azotobacter	352	G	7221	1031	8252	0.00041
Halopseudomonas	2901189	G	3851	540	4391	0.00022
Marinobacter	2742	G	7606	474	8080	0.00041
Klebsiella	570	G	9674	48062	57736	0.00290
Raoultella	160674	G	2459	1068	3527	0.00018
Enterobacter	547	G	10609	18137	28746	0.00144
Citrobacter	544	G	4662	3878	8540	0.00043
Cronobacter	413496	G	3015	582	3597	0.00018
Leclercia	83654	G	2704	1296	4000	0.00020
Kosakonia	1330547	G	2555	347	2902	0.00015
Salmonella	590	G	2189	59238	61427	0.00309
Pluralibacter	1330546	G	1838	364	2202	0.00011
Escherichia	561	G	1606	21876	23482	0.00118
Cedecea	158483	G	1477	166	1643	0.00008
Serratia	613	G	16081	9828	25909	0.00130
Yersinia	629	G	1810	1845	3655	0.00018
Rahnella	34037	G	1548	274	1822	0.00009
Nissabacter	1964366	G	1022	110	1132	0.00006
Pantoea	53335	G	9845	1491	11336	0.00057
Erwinia	551	G	3811	604	4415	0.00022
Mixta	2100764	G	2195	518	2713	0.00014
Dickeya	204037	G	4399	4439	8838	0.00044
Pectobacterium	122277	G	2497	350	2847	0.00014
Brenneria	71655	G	1613	115	1728	0.00009
Edwardsiella	635	G	2668	704	3372	0.00017
Sodalis	84565	G	1866	97	1963	0.00010
Thioalkalivibrio	106633	G	10290	1343	11633	0.00058
Spiribacter	1335745	G	6479	354	6833	0.00034
Acidihalobacter	1765964	G	4491	281	4772	0.00024
Halorhodospira	85108	G	2167	136	2303	0.00012
Aquisalimonas	406099	G	1893	99	1992	0.00010
Alkalilimnicola	133193	G	1835	178	2013	0.00010
Ectothiorhodospira	1051	G	1766	128	1894	0.00010
Thiodictyon	53392	G	3837	160	3997	0.00020
Allochromatium	85072	G	3630	663	4293	0.00022
Marichromatium	85076	G	3387	512	3899	0.00020
Thioflavicoccus	156885	G	3276	232	3508	0.00018
Thiocapsa	1056	G	2487	105	2592	0.00013
Thiocystis	13724	G	1951	131	2082	0.00010
Thermochromatium	85073	G	1046	203	1249	0.00006
Wenzhouxiangella	1676142	G	3378	126	3504	0.00018
Thiohalobacter	1273155	G	2574	242	2816	0.00014
Guyparkeria	2035712	G	2017	369	2386	0.00012
Sulfurivermis	2034504	G	1856	522	2378	0.00012
Halothiobacillus	109262	G	1335	84	1419	0.00007
Halomonas	2745	G	37740	4259	41999	0.00211
Cobetia	204286	G	2488	1405	3893	0.00020
Halotalea	376488	G	2185	313	2498	0.00013
Salinicola	404432	G	2179	188	2367	0.00012
Kushneria	504090	G	1688	61	1749	0.00009
Chromohalobacter	42054	G	1399	115	1514	0.00008
Alcanivorax	59753	G	4923	1730	6653	0.00033
Marinobacterium	48075	G	1600	157	1757	0.00009
Hahella	158481	G	1079	32	1111	0.00006
Aeromonas	642	G	22011	13817	35828	0.00180
Zobellella	347533	G	1414	260	1674	0.00008
Methylococcus	413	G	7163	409	7572	0.00038
Methylomonas	416	G	4742	126	4868	0.00024
Methylomagnum	1760987	G	2103	73	2176	0.00011
Methylomicrobium	39773	G	1849	418	2267	0.00011
Methylocaldum	73778	G	1761	79	1840	0.00009
Methylogaea	1295378	G	1737	106	1843	0.00009
Shewanella	22	G	6703	872	7575	0.00038
Pseudoalteromonas	53246	G	1989	231	2220	0.00011
Microbulbifer	48073	G	6364	326	6690	0.00034
Kineobactrum	2678529	G	1141	45	1186	0.00006
Halioglobus	1217416	G	1009	35	1044	0.00005
Cellvibrio	10	G	1294	50	1344	0.00007
Sulfurifustis	1692042	G	6977	336	7313	0.00037
Sulfuricaulis	1744881	G	2938	171	3109	0.00016
Acidiferrobacter	986106	G	2426	35	2461	0.00012
Solimonas	413435	G	6354	473	6827	0.00034
Flagellatimonas	2893022	G	1975	96	2071	0.00010
Sinimarinibacterium	1861863	G	1028	399	1427	0.00007
Steroidobacter	469322	G	2796	540	3336	0.00017
Vibrio	662	G	6616	2346	8962	0.00045
Photobacterium	657	G	1029	143	1172	0.00006
Immundisolibacter	1934947	G	4897	654	5551	0.00028
Acinetobacter	469	G	3400	1507	4907	0.00025
Legionella	445	G	2714	244	2958	0.00015
Thiothrix	1030	G	1104	32	1136	0.00006
Salinisphaera	180541	G	2275	1941	4216	0.00021
Cardiobacterium	2717	G	1246	126	1372	0.00007
Anaeromyxobacter	161492	G	114509	5911	120420	0.00605
Corallococcus	83461	G	32411	1588	33999	0.00171
Myxococcus	32	G	27221	63475	90696	0.00456
Pyxidicoccus	224458	G	27078	686	27764	0.00140
Archangium	47	G	31624	2929	34553	0.00174
Cystobacter	42	G	8203	1872	10075	0.00051
Stigmatella	40	G	7399	373	7772	0.00039
Melittangium	44	G	6314	1292	7606	0.00038
Vulgatibacter	1524214	G	7905	421	8326	0.00042
Sorangium	39643	G	101182	9464	110646	0.00556
Polyangium	55	G	26555	2102	28657	0.00144
Chondromyces	50	G	12692	495	13187	0.00066
Sandaracinus	1055688	G	41811	1709	43520	0.00219
Labilithrix	1524217	G	24263	874	25137	0.00126
Haliangium	162027	G	17777	637	18414	0.00093
Geomonas	2651583	G	13396	1786	15182	0.00076
Geobacter	28231	G	11509	969	12478	0.00063
Citrifermentans	2883512	G	4074	814	4888	0.00025
Geotalea	2910589	G	2132	115	2247	0.00011
Desulfuromonas	890	G	8276	783	9059	0.00046
Pelobacter	18	G	1346	363	1709	0.00009
Syntrophotalea	2812025	G	1698	155	1853	0.00009
Desulfovibrio	872	G	8152	876	9028	0.00045
Pseudodesulfovibrio	2035811	G	7990	1109	9099	0.00046
Solidesulfovibrio	2910984	G	5388	453	5841	0.00029
Oceanidesulfovibrio	2905722	G	2146	103	2249	0.00011
Desulfocurvibacter	2582840	G	1576	89	1665	0.00008
Desulfolutivibrio	2773294	G	1326	289	1615	0.00008
Megalodesulfovibrio	2910978	G	1232	47	1279	0.00006
Desulfomicrobium	898	G	1631	136	1767	0.00009
Desulfosarcina	2299	G	3517	437	3954	0.00020
Desulfobulbus	893	G	2157	289	2446	0.00012
Persicimonas	2766927	G	6070	140	6210	0.00031
Bradymonas	1779136	G	2215	894	3109	0.00016
Syntrophobacter	29526	G	1386	365	1751	0.00009
Desulfarculus	453229	G	2287	840	3127	0.00016
Campylobacter	194	G	1518	247	1765	0.00009
Bdellovibrio	958	G	1667	61	1728	0.00009
Bacteriovorax	146784	G	1128	15	1143	0.00006
Acidithiobacillus	119977	G	2825	216	3041	0.00015
Gemmata	113	G	32195	2599	34794	0.00175
Urbifossiella	2807415	G	29711	2138	31849	0.00160
Frigoriglobus	2774146	G	17436	2384	19820	0.00100
Limnoglobus	2731450	G	12417	484	12901	0.00065
Tuwongella	2051044	G	1627	55	1682	0.00008
Telmatocola	1382832	G	1202	9	1211	0.00006
Aquisphaera	1511635	G	18404	2366	20770	0.00104
Tautonia	2680020	G	15378	1017	16395	0.00082
Paludisphaera	1763521	G	13997	2320	16317	0.00082
Singulisphaera	466152	G	13455	1497	14952	0.00075
Isosphaera	127	G	1997	110	2107	0.00011
Stieleria	2795973	G	4158	350	4508	0.00023
Rosistilla	2795779	G	3765	209	3974	0.00020
Lignipirellula	2795775	G	3673	311	3984	0.00020
Anatilimnocola	2807414	G	3639	288	3927	0.00020
Bremerella	2714594	G	2338	131	2469	0.00012
Pirellula	123	G	2310	61	2371	0.00012
Roseimaritima	1579506	G	2177	109	2286	0.00011
Rubripirellula	1579505	G	1091	153	1244	0.00006
Lacipirellula	2691417	G	8970	514	9484	0.00048
Pirellulimonas	2795783	G	5107	463	5570	0.00028
Botrimarina	2795782	G	4283	334	4617	0.00023
Aeoliella	2795781	G	1696	119	1815	0.00009
Planctomyces	118	G	18300	3414	21714	0.00109
Gimesia	1649453	G	6252	275	6527	0.00033
Caulifigura	2795778	G	5073	264	5337	0.00027
Alienimonas	2714737	G	4390	257	4647	0.00023
Maioricimonas	2795777	G	3983	406	4389	0.00022
Symmachiella	2795780	G	1907	91	1998	0.00010
Fuerstiella	1936111	G	1141	16	1157	0.00006
Crateriforma	2714592	G	1058	163	1221	0.00006
Planctopirus	1649480	G	1043	33	1076	0.00005
Rubinisphaera	1649490	G	1038	83	1121	0.00006
Humisphaera	2807511	G	9351	185	9536	0.00048
Phycisphaera	666508	G	4582	307	4889	0.00025
Mucisphaera	2913022	G	1908	94	2002	0.00010
Opitutus	178440	G	20207	1561	21768	0.00109
Lacunisphaera	1961799	G	5682	756	6438	0.00032
Oleiharenicola	2100741	G	5093	248	5341	0.00027
Nibricoccus	2576890	G	4557	186	4743	0.00024
Ereboglobus	2028344	G	2736	117	2853	0.00014
Ruficoccus	2175957	G	1158	129	1287	0.00006
Verrucomicrobium	2735	G	5803	402	6205	0.00031
Luteolibacter	518753	G	4389	150	4539	0.00023
Roseimicrobium	1348508	G	3146	108	3254	0.00016
Akkermansia	239934	G	2063	115	2178	0.00011
Methylacidimicrobium	1541670	G	1831	144	1975	0.00010
Kiritimatiella	1921784	G	1304	1145	2449	0.00012
Gemmatirosa	1706036	G	110433	8281	118714	0.00596
Gemmatimonas	173479	G	37424	861	38285	0.00192
Hymenobacter	89966	G	28078	1292	29370	0.00148
Pontibacter	323449	G	3002	361	3363	0.00017
Spirosoma	107	G	5412	226	5638	0.00028
Chryseolinea	1433993	G	5036	115	5151	0.00026
Dyadobacter	120831	G	1722	93	1815	0.00009
Fibrella	861914	G	1551	93	1644	0.00008
Flavobacterium	237	G	4821	1038	5859	0.00029
Chryseobacterium	59732	G	4271	1174	5445	0.00027
Alistipes	239759	G	7478	2054	9532	0.00048
Prevotella	838	G	2731	256	2987	0.00015
Bacteroides	816	G	2116	792	2908	0.00015
Chitinophaga	79328	G	3578	252	3830	0.00019
Panacibacter	1874621	G	3303	189	3492	0.00018
Flavisolibacter	398041	G	1774	163	1937	0.00010
Niastella	354354	G	1086	148	1234	0.00006
Mucilaginibacter	423349	G	9816	540	10356	0.00052
Pedobacter	84567	G	2056	104	2160	0.00011
Sphingobacterium	28453	G	1337	463	1800	0.00009
Rhodothermus	29548	G	5058	221	5279	0.00027
Rhodocaloribacter	2893090	G	5045	419	5464	0.00027
Salinibacter	146918	G	3473	43	3516	0.00018
Chlorobaculum	256319	G	2705	204	2909	0.00015
Prosthecochloris	1101	G	1110	99	1209	0.00006
Granulicella	940557	G	16128	1615	17743	0.00089
Candidatus Koribacter	658061	G	13065	428	13493	0.00068
Terriglobus	392733	G	12014	1435	13449	0.00068
Acidobacterium	33973	G	10811	867	11678	0.00059
Edaphobacter	388463	G	8426	1072	9498	0.00048
Acidisarcina	2608728	G	3696	272	3968	0.00020
Paludibaculum	1649475	G	12009	280	12289	0.00062
Luteitalea	2004797	G	41485	2068	43553	0.00219
Chloracidobacterium	458032	G	4486	116	4602	0.00023
Sulfidibacter	2915177	G	2793	43	2836	0.00014
Nitrospira	1234	G	10856	131	10987	0.00055
Treponema	157	G	1779	468	2247	0.00011
Spirochaeta	146	G	1181	34	1215	0.00006
Pyramidobacter	638847	G	1027	111	1138	0.00006
Candidatus Bipolaricaulis	2250122	G	1022	31	1053	0.00005
Fusarium	5506	G	23736	1662	25398	0.00128
Trichoderma	5543	G	7965	498	8463	0.00043
Beauveria	5581	G	5533	275	5808	0.00029
Cordyceps	45234	G	2194	166	2360	0.00012
Metarhizium	5529	G	4379	659	5038	0.00025
Ustilaginoidea	124426	G	1291	82	1373	0.00007
Purpureocillium	1052105	G	2453	263	2716	0.00014
Drechmeria	98402	G	1792	110	1902	0.00010
Colletotrichum	5455	G	2539	440	2979	0.00015
Thermothielavioides	2609811	G	2818	137	2955	0.00015
Thermothelomyces	1920207	G	2023	72	2095	0.00011
Pyricularia	48558	G	3143	20	3163	0.00016
Neopestalotiopsis	1562158	G	1572	19	1591	0.00008
Aspergillus	5052	G	2252	95	2347	0.00012
Penicillium	5073	G	1661	80	1741	0.00009
Pseudozyma	63298	G	3698	104	3802	0.00019
Phlebiopsis	82309	G	1305	22	1327	0.00007
Phytophthora	4783	G	10959	1170	12129	0.00061
Pythium	4797	G	1050	17	1067	0.00005
